data_somministrazione,area,totale,sesso_maschile,sesso_femminile,prima_dose,seconda_dose,codice_NUTS1,codice_NUTS2,codice_regione_ISTAT,nome_area
2021-02-12,PAB,730,217,513,482,248,ITH,ITH1,4,Provincia Autonoma Bolzano / Bozen
2021-05-20,MAR,12365,5814,6551,7666,4699,ITI,ITI3,11,Marche
2021-01-16,PIE,7771,2630,5141,7771,0,ITC,ITC1,1,Piemonte
2021-02-11,SAR,1315,490,825,1204,111,ITG,ITG2,20,Sardegna
2021-01-30,UMB,1590,490,1100,44,1546,ITI,ITI2,10,Umbria
2021-05-03,PAT,4235,2179,2056,4082,153,ITH,ITH2,4,Provincia Autonoma Trento
2021-03-28,SIC,10909,5132,5777,6898,4011,ITG,ITG1,19,Sicilia
2021-03-04,CAL,5465,3183,2282,4668,797,ITF,ITF6,18,Calabria
2021-05-31,LAZ,49500,21195,28305,31221,18279,ITI,ITI4,12,Lazio
2021-02-07,MAR,1868,734,1134,344,1524,ITI,ITI3,11,Marche
2021-01-10,BAS,77,24,53,77,0,ITF,ITF5,17,Basilicata
2021-03-29,MOL,2033,835,1198,1547,486,ITF,ITF2,14,Molise
2021-02-16,VEN,6639,2870,3769,6462,177,ITH,ITH3,5,Veneto
2021-03-15,BAS,2352,983,1369,521,1831,ITF,ITF5,17,Basilicata
2021-05-29,SAR,17693,8496,9197,13296,4397,ITG,ITG2,20,Sardegna
2021-01-16,PAT,319,148,171,319,0,ITH,ITH2,4,Provincia Autonoma Trento
2021-04-17,PAB,5232,2598,2634,5188,44,ITH,ITH1,4,Provincia Autonoma Bolzano / Bozen
2021-03-21,PIE,10723,4738,5985,4189,6534,ITC,ITC1,1,Piemonte
2021-04-02,LOM,41143,16830,24313,26691,14452,ITC,ITC4,3,Lombardia
2021-04-17,PUG,39843,18878,20965,36277,3566,ITF,ITF4,16,Puglia
2021-05-29,VEN,32257,16318,15939,25200,7057,ITH,ITH3,5,Veneto
2021-04-27,BAS,4726,2242,2484,4401,325,ITF,ITF5,17,Basilicata
2021-04-07,LIG,13583,6031,7552,11294,2289,ITC,ITC3,7,Liguria
2021-03-23,FVG,3753,1559,2194,1613,2140,ITH,ITH4,6,Friuli-Venezia Giulia
2021-03-15,ABR,3624,1389,2235,1816,1808,ITF,ITF1,13,Abruzzo
2021-05-12,UMB,6467,3011,3456,4324,2143,ITI,ITI2,10,Umbria
2021-04-18,EMR,17494,8392,9102,12568,4926,ITH,ITH5,8,Emilia-Romagna
2021-04-28,PAT,4241,1972,2269,4103,138,ITH,ITH2,4,Provincia Autonoma Trento
2021-03-28,LAZ,18837,7541,11296,13527,5310,ITI,ITI4,12,Lazio
2021-05-21,VDA,917,433,484,531,386,ITC,ITC2,2,Valle d'Aosta / Vallée d'Aoste
2021-01-10,ABR,1139,409,730,1139,0,ITF,ITF1,13,Abruzzo
2021-05-30,VDA,865,429,436,694,171,ITC,ITC2,2,Valle d'Aosta / Vallée d'Aoste
2020-12-31,PAB,912,518,394,912,0,ITH,ITH1,4,Provincia Autonoma Bolzano / Bozen
2021-01-15,ABR,379,149,230,379,0,ITF,ITF1,13,Abruzzo
2021-01-11,TOS,5094,1691,3403,5094,0,ITI,ITI1,9,Toscana
2021-05-24,SAR,13595,6510,7085,8433,5162,ITG,ITG2,20,Sardegna
2021-02-17,VDA,327,144,183,227,100,ITC,ITC2,2,Valle d'Aosta / Vallée d'Aoste
2021-01-23,FVG,816,324,492,4,812,ITH,ITH4,6,Friuli-Venezia Giulia
2021-02-23,TOS,7721,3324,4397,7560,161,ITI,ITI1,9,Toscana
2021-04-27,ABR,9085,4371,4714,6617,2468,ITF,ITF1,13,Abruzzo
2021-05-05,FVG,9708,4231,5477,6267,3441,ITH,ITH4,6,Friuli-Venezia Giulia
2021-01-14,PUG,4070,1589,2481,4070,0,ITF,ITF4,16,Puglia
2021-04-07,MAR,7810,3435,4375,7475,335,ITI,ITI3,11,Marche
2021-02-23,LIG,3806,1559,2247,3697,109,ITC,ITC3,7,Liguria
2021-04-26,PUG,26088,11947,14141,22857,3231,ITF,ITF4,16,Puglia
2021-04-12,PAB,2105,946,1159,2098,7,ITH,ITH1,4,Provincia Autonoma Bolzano / Bozen
2021-03-30,UMB,3948,1705,2243,2416,1532,ITI,ITI2,10,Umbria
2021-04-16,VEN,24421,10481,13940,12538,11883,ITH,ITH3,5,Veneto
2020-12-27,UMB,86,45,41,86,0,ITI,ITI2,10,Umbria
2021-04-17,VDA,638,407,231,636,2,ITC,ITC2,2,Valle d'Aosta / Vallée d'Aoste
2021-04-11,LOM,32200,13937,18263,24809,7391,ITC,ITC4,3,Lombardia
2021-06-02,SAR,5908,2810,3098,5166,742,ITG,ITG2,20,Sardegna
2021-01-10,EMR,7168,2683,4485,7168,0,ITH,ITH5,8,Emilia-Romagna
2021-04-06,SIC,17821,8542,9279,13495,4326,ITG,ITG1,19,Sicilia
2020-12-30,LOM,114,42,72,114,0,ITC,ITC4,3,Lombardia
2021-01-05,VDA,150,54,96,150,0,ITC,ITC2,2,Valle d'Aosta / Vallée d'Aoste
2021-01-09,PAB,612,326,286,612,0,ITH,ITH1,4,Provincia Autonoma Bolzano / Bozen
2021-01-25,PAT,817,215,602,23,794,ITH,ITH2,4,Provincia Autonoma Trento
2021-01-29,CAL,2049,988,1061,230,1819,ITF,ITF6,18,Calabria
2021-01-09,PUG,4886,2251,2635,4886,0,ITF,ITF4,16,Puglia
2021-01-19,BAS,199,84,115,199,0,ITF,ITF5,17,Basilicata
2021-01-13,VEN,5985,1606,4379,5985,0,ITH,ITH3,5,Veneto
2021-03-30,PIE,16891,7033,9858,9020,7871,ITC,ITC1,1,Piemonte
2021-02-09,ABR,908,311,597,499,409,ITF,ITF1,13,Abruzzo
2021-04-07,MOL,1688,847,841,1413,275,ITF,ITF2,14,Molise
2021-04-01,FVG,6315,2993,3322,5300,1015,ITH,ITH4,6,Friuli-Venezia Giulia
2021-03-30,PAT,2387,973,1414,1750,637,ITH,ITH2,4,Provincia Autonoma Trento
2021-03-24,BAS,1753,688,1065,1358,395,ITF,ITF5,17,Basilicata
2021-04-23,TOS,25676,11429,14247,9361,16315,ITI,ITI1,9,Toscana
2021-03-14,PUG,3320,1429,1891,2509,811,ITF,ITF4,16,Puglia
2021-01-25,PIE,6215,1938,4277,983,5232,ITC,ITC1,1,Piemonte
2021-02-20,SAR,2041,855,1186,1707,334,ITG,ITG2,20,Sardegna
2021-05-02,TOS,11167,4931,6236,9204,1963,ITI,ITI1,9,Toscana
2021-01-08,SAR,3258,1184,2074,3258,0,ITG,ITG2,20,Sardegna
2021-04-16,MAR,10082,4702,5380,9557,525,ITI,ITI3,11,Marche
2021-02-27,CAM,13950,4473,9477,12308,1642,ITF,ITF3,15,Campania
2021-02-27,LOM,13946,5870,8076,13305,641,ITC,ITC4,3,Lombardia
2021-04-21,PAB,3012,1468,1544,2164,848,ITH,ITH1,4,Provincia Autonoma Bolzano / Bozen
2021-01-20,TOS,1331,637,694,1083,248,ITI,ITI1,9,Toscana
2021-04-20,SAR,10992,4992,6000,7778,3214,ITG,ITG2,20,Sardegna
2021-01-04,MAR,1506,568,938,1506,0,ITI,ITI3,11,Marche
2021-01-08,VEN,9404,2835,6569,9404,0,ITH,ITH3,5,Veneto
2021-02-22,SIC,8012,4146,3866,7521,491,ITG,ITG1,19,Sicilia
2021-04-27,LAZ,30628,13821,16807,19785,10843,ITI,ITI4,12,Lazio
2021-05-02,CAM,43483,21537,21946,32132,11351,ITF,ITF3,15,Campania
2021-05-28,PAT,3401,1596,1805,1346,2055,ITH,ITH2,4,Provincia Autonoma Trento
2021-01-14,VDA,237,69,168,237,0,ITC,ITC2,2,Valle d'Aosta / Vallée d'Aoste
2021-03-25,PAT,2873,1103,1770,1824,1049,ITH,ITH2,4,Provincia Autonoma Trento
2021-03-24,ABR,6386,2785,3601,4134,2252,ITF,ITF1,13,Abruzzo
2020-12-30,MAR,17,5,12,17,0,ITI,ITI3,11,Marche
2021-02-22,LAZ,11456,4990,6466,10954,502,ITI,ITI4,12,Lazio
2021-02-23,MOL,582,223,359,363,219,ITF,ITF2,14,Molise
2021-03-04,LIG,4738,2118,2620,3891,847,ITC,ITC3,7,Liguria
2021-04-08,UMB,5832,2465,3367,4037,1795,ITI,ITI2,10,Umbria
2021-04-25,VEN,18313,8148,10165,13480,4833,ITH,ITH3,5,Veneto
2021-05-28,PIE,34641,16314,18327,18934,15707,ITC,ITC1,1,Piemonte
2021-05-02,CAL,12499,5834,6665,10662,1837,ITF,ITF6,18,Calabria
2021-05-22,TOS,25961,12629,13332,21704,4257,ITI,ITI1,9,Toscana
2021-02-20,CAL,1418,760,658,1100,318,ITF,ITF6,18,Calabria
2021-02-07,PUG,1579,669,910,253,1326,ITF,ITF4,16,Puglia
2021-02-22,VDA,316,94,222,213,103,ITC,ITC2,2,Valle d'Aosta / Vallée d'Aoste
2021-05-01,PUG,27469,12578,14891,16821,10648,ITF,ITF4,16,Puglia
2021-02-09,TOS,4488,1468,3020,3877,611,ITI,ITI1,9,Toscana
2021-01-28,PAT,530,147,383,48,482,ITH,ITH2,4,Provincia Autonoma Trento
2021-03-21,LAZ,17858,6826,11032,12807,5051,ITI,ITI4,12,Lazio
2021-01-12,PAB,1709,459,1250,1709,0,ITH,ITH1,4,Provincia Autonoma Bolzano / Bozen
2021-04-12,PUG,29101,13707,15394,26276,2825,ITF,ITF4,16,Puglia
2021-04-15,BAS,3386,1659,1727,2632,754,ITF,ITF5,17,Basilicata
2021-01-17,MOL,78,38,40,48,30,ITF,ITF2,14,Molise
2021-04-09,LAZ,27297,12266,15031,19074,8223,ITI,ITI4,12,Lazio
2021-01-13,EMR,9074,2940,6134,9074,0,ITH,ITH5,8,Emilia-Romagna
2020-12-28,SIC,211,126,85,211,0,ITG,ITG1,19,Sicilia
2021-04-10,MOL,2635,1259,1376,2483,152,ITF,ITF2,14,Molise
2021-05-31,CAM,40091,20085,20006,30083,10008,ITF,ITF3,15,Campania
2021-01-03,BAS,901,344,557,901,0,ITF,ITF5,17,Basilicata
2021-02-05,MOL,593,269,324,55,538,ITF,ITF2,14,Molise
2021-03-11,CAL,7251,3417,3834,5989,1262,ITF,ITF6,18,Calabria
2021-01-18,UMB,614,219,395,529,85,ITI,ITI2,10,Umbria
2021-05-03,LOM,83640,39731,43909,71524,12116,ITC,ITC4,3,Lombardia
2021-04-23,FVG,7455,3375,4080,3599,3856,ITH,ITH4,6,Friuli-Venezia Giulia
2021-02-23,SAR,1519,1010,509,1285,234,ITG,ITG2,20,Sardegna
2021-05-17,VEN,26365,12937,13428,16434,9931,ITH,ITH3,5,Veneto
2021-03-28,LOM,20467,7803,12664,14304,6163,ITC,ITC4,3,Lombardia
2021-03-26,LIG,9121,3855,5266,5967,3154,ITC,ITC3,7,Liguria
2021-02-06,VEN,4095,1354,2741,709,3386,ITH,ITH3,5,Veneto
2021-03-04,LAZ,18655,8014,10641,13639,5016,ITI,ITI4,12,Lazio
2021-05-05,TOS,30093,13426,16667,15646,14447,ITI,ITI1,9,Toscana
2021-05-19,SAR,14853,7285,7568,11389,3464,ITG,ITG2,20,Sardegna
2021-03-28,CAM,15552,7501,8051,13927,1625,ITF,ITF3,15,Campania
2021-01-21,PUG,2132,904,1228,1271,861,ITF,ITF4,16,Puglia
2021-01-22,ABR,118,57,61,118,0,ITF,ITF1,13,Abruzzo
2021-04-23,PIE,27434,12597,14837,20672,6762,ITC,ITC1,1,Piemonte
2021-05-31,CAL,15105,7203,7902,7268,7837,ITF,ITF6,18,Calabria
2021-02-11,TOS,5383,2021,3362,5141,242,ITI,ITI1,9,Toscana
2021-03-23,SIC,21066,10077,10989,15412,5654,ITG,ITG1,19,Sicilia
2021-01-02,PUG,2949,1301,1648,2949,0,ITF,ITF4,16,Puglia
2020-12-30,LAZ,1630,629,1001,1630,0,ITI,ITI4,12,Lazio
2021-04-23,EMR,29551,13807,15744,14672,14879,ITH,ITH5,8,Emilia-Romagna
2021-04-23,PAT,3600,1749,1851,3546,54,ITH,ITH2,4,Provincia Autonoma Trento
2021-03-27,ABR,6122,2621,3501,3637,2485,ITF,ITF1,13,Abruzzo
2021-04-16,LOM,53617,23903,29714,39279,14338,ITC,ITC4,3,Lombardia
2021-05-08,MAR,12270,5477,6793,5023,7247,ITI,ITI3,11,Marche
2021-01-11,EMR,9348,3273,6075,9348,0,ITH,ITH5,8,Emilia-Romagna
2021-01-23,LOM,1114,357,757,916,198,ITC,ITC4,3,Lombardia
2021-04-12,MOL,1299,557,742,1048,251,ITF,ITF2,14,Molise
2021-01-25,TOS,5127,1896,3231,248,4879,ITI,ITI1,9,Toscana
2021-04-02,MAR,6875,2973,3902,6135,740,ITI,ITI3,11,Marche
2021-02-08,SAR,1470,533,937,856,614,ITG,ITG2,20,Sardegna
2021-03-25,SIC,20635,9556,11079,15096,5539,ITG,ITG1,19,Sicilia
2021-04-07,PAB,1777,802,975,1238,539,ITH,ITH1,4,Provincia Autonoma Bolzano / Bozen
2021-03-25,UMB,3904,1699,2205,2840,1064,ITI,ITI2,10,Umbria
2021-04-29,VDA,1291,634,657,757,534,ITC,ITC2,2,Valle d'Aosta / Vallée d'Aoste
2021-03-07,MOL,1132,501,631,1130,2,ITF,ITF2,14,Molise
2021-03-11,LOM,36197,13466,22731,26298,9899,ITC,ITC4,3,Lombardia
2021-05-16,CAM,51114,23197,27917,33568,17546,ITF,ITF3,15,Campania
2021-03-26,PUG,11540,5420,6120,6895,4645,ITF,ITF4,16,Puglia
2021-01-13,PAT,421,123,298,421,0,ITH,ITH2,4,Provincia Autonoma Trento
2021-02-18,LIG,2761,1126,1635,2430,331,ITC,ITC3,7,Liguria
2021-03-06,LAZ,18303,7051,11252,14046,4257,ITI,ITI4,12,Lazio
2021-02-03,CAM,8903,4003,4900,878,8025,ITF,ITF3,15,Campania
2021-04-11,VEN,21002,8873,12129,14695,6307,ITH,ITH3,5,Veneto
2021-03-18,PIE,11756,4803,6953,4029,7727,ITC,ITC1,1,Piemonte
2021-03-20,FVG,3340,1351,1989,1249,2091,ITH,ITH4,6,Friuli-Venezia Giulia
2021-01-28,MAR,2086,725,1361,165,1921,ITI,ITI3,11,Marche
2021-05-31,LIG,14316,7094,7222,8924,5392,ITC,ITC3,7,Liguria
2021-01-06,LOM,7059,2491,4568,7059,0,ITC,ITC4,3,Lombardia
2021-05-16,CAL,13772,6725,7047,9958,3814,ITF,ITF6,18,Calabria
2021-03-12,ABR,6015,1986,4029,4433,1582,ITF,ITF1,13,Abruzzo
2021-01-29,LAZ,8042,3079,4963,813,7229,ITI,ITI4,12,Lazio
2021-03-18,PAT,2319,957,1362,1239,1080,ITH,ITH2,4,Provincia Autonoma Trento
2021-05-14,CAL,19942,9588,10354,13072,6870,ITF,ITF6,18,Calabria
2021-03-08,UMB,3672,1801,1871,2309,1363,ITI,ITI2,10,Umbria
2021-01-19,VDA,256,77,179,256,0,ITC,ITC2,2,Valle d'Aosta / Vallée d'Aoste
2021-02-03,CAL,2765,1429,1336,580,2185,ITF,ITF6,18,Calabria
2021-03-02,PAB,695,200,495,693,2,ITH,ITH1,4,Provincia Autonoma Bolzano / Bozen
2021-03-11,CAM,17584,8672,8912,10306,7278,ITF,ITF3,15,Campania
2021-02-20,CAM,8573,3080,5493,8270,303,ITF,ITF3,15,Campania
2021-03-29,BAS,2435,881,1554,2149,286,ITF,ITF5,17,Basilicata
2021-01-05,BAS,946,409,537,946,0,ITF,ITF5,17,Basilicata
2021-03-18,FVG,3372,1421,1951,1691,1681,ITH,ITH4,6,Friuli-Venezia Giulia
2021-05-28,SIC,51109,22794,28315,24773,26336,ITG,ITG1,19,Sicilia
2021-01-01,VEN,1528,471,1057,1528,0,ITH,ITH3,5,Veneto
2021-05-07,TOS,32078,14671,17407,11989,20089,ITI,ITI1,9,Toscana
2021-03-28,PUG,3527,1650,1877,1202,2325,ITF,ITF4,16,Puglia
2021-05-14,LIG,12875,5647,7228,8578,4297,ITC,ITC3,7,Liguria
2021-04-13,VEN,14019,6319,7700,8534,5485,ITH,ITH3,5,Veneto
2021-01-13,FVG,2650,834,1816,2650,0,ITH,ITH4,6,Friuli-Venezia Giulia
2021-04-04,MAR,3824,1792,2032,2655,1169,ITI,ITI3,11,Marche
2021-02-20,LIG,1335,637,698,1334,1,ITC,ITC3,7,Liguria
2021-04-14,VDA,941,430,511,717,224,ITC,ITC2,2,Valle d'Aosta / Vallée d'Aoste
2021-04-15,SAR,11821,5525,6296,6865,4956,ITG,ITG2,20,Sardegna
2021-01-03,VEN,5157,1562,3595,5157,0,ITH,ITH3,5,Veneto
2021-03-20,PIE,11921,4898,7023,6023,5898,ITC,ITC1,1,Piemonte
2021-03-04,PAB,1714,1004,710,1485,229,ITH,ITH1,4,Provincia Autonoma Bolzano / Bozen
2021-04-16,LAZ,34394,15676,18718,22335,12059,ITI,ITI4,12,Lazio
2021-04-18,CAL,5837,2788,3049,4930,907,ITF,ITF6,18,Calabria
2021-04-08,BAS,764,348,416,754,10,ITF,ITF5,17,Basilicata
2021-03-26,TOS,20404,9160,11244,14644,5760,ITI,ITI1,9,Toscana
2021-04-20,VDA,932,430,502,738,194,ITC,ITC2,2,Valle d'Aosta / Vallée d'Aoste
2021-03-30,EMR,23286,10292,12994,18249,5037,ITH,ITH5,8,Emilia-Romagna
2021-03-24,MAR,7032,2983,4049,3364,3668,ITI,ITI3,11,Marche
2021-03-10,MAR,5666,2400,3266,4529,1137,ITI,ITI3,11,Marche
2021-05-17,PAT,4292,2121,2171,3942,350,ITH,ITH2,4,Provincia Autonoma Trento
2021-02-13,CAM,5508,2550,2958,5291,217,ITF,ITF3,15,Campania
2021-05-22,VEN,34665,16639,18026,13306,21359,ITH,ITH3,5,Veneto
2021-02-12,MOL,330,149,181,208,122,ITF,ITF2,14,Molise
2021-05-10,SAR,9732,4336,5396,7195,2537,ITG,ITG2,20,Sardegna
2021-01-28,VEN,9209,2662,6547,173,9036,ITH,ITH3,5,Veneto
2021-03-14,SIC,8779,3930,4849,4943,3836,ITG,ITG1,19,Sicilia
2021-05-18,PAB,3303,1727,1576,2139,1164,ITH,ITH1,4,Provincia Autonoma Bolzano / Bozen
2021-03-22,ABR,4281,1852,2429,2311,1970,ITF,ITF1,13,Abruzzo
2021-02-11,SIC,5321,2097,3224,4859,462,ITG,ITG1,19,Sicilia
2021-02-25,LAZ,12654,5518,7136,11604,1050,ITI,ITI4,12,Lazio
2021-02-06,FVG,1154,338,816,22,1132,ITH,ITH4,6,Friuli-Venezia Giulia
2021-04-14,PAT,3115,1464,1651,2379,736,ITH,ITH2,4,Provincia Autonoma Trento
2021-01-19,MAR,228,83,145,142,86,ITI,ITI3,11,Marche
2021-05-19,EMR,33515,14892,18623,18488,15027,ITH,ITH5,8,Emilia-Romagna
2021-05-13,MAR,12601,5694,6907,7102,5499,ITI,ITI3,11,Marche
2021-03-15,MOL,832,338,494,587,245,ITF,ITF2,14,Molise
2021-02-15,VDA,264,136,128,229,35,ITC,ITC2,2,Valle d'Aosta / Vallée d'Aoste
2021-06-02,EMR,23242,11594,11648,18717,4525,ITH,ITH5,8,Emilia-Romagna
2021-04-04,CAM,7959,4012,3947,6915,1044,ITF,ITF3,15,Campania
2021-05-11,BAS,2654,1353,1301,1621,1033,ITF,ITF5,17,Basilicata
2021-05-29,TOS,31432,15196,16236,23344,8088,ITI,ITI1,9,Toscana
2021-02-13,CAL,1396,603,793,1031,365,ITF,ITF6,18,Calabria
2021-05-17,PIE,30612,14371,16241,17674,12938,ITC,ITC1,1,Piemonte
2021-04-16,SIC,28740,14421,14319,20364,8376,ITG,ITG1,19,Sicilia
2021-04-02,VEN,23977,10550,13427,17646,6331,ITH,ITH3,5,Veneto
2021-03-29,PAB,1171,499,672,412,759,ITH,ITH1,4,Provincia Autonoma Bolzano / Bozen
2021-05-11,ABR,10737,5098,5639,5909,4828,ITF,ITF1,13,Abruzzo
2021-03-09,TOS,10674,4152,6522,5122,5552,ITI,ITI1,9,Toscana
2021-01-11,VEN,7238,2101,5137,7238,0,ITH,ITH3,5,Veneto
2021-04-09,TOS,24531,10546,13985,21122,3409,ITI,ITI1,9,Toscana
2021-01-04,FVG,1507,558,949,1507,0,ITH,ITH4,6,Friuli-Venezia Giulia
2021-02-21,MAR,376,141,235,375,1,ITI,ITI3,11,Marche
2021-04-04,CAL,1762,886,876,1262,500,ITF,ITF6,18,Calabria
2021-03-28,PIE,16054,6899,9155,8433,7621,ITC,ITC1,1,Piemonte
2021-02-25,SIC,10118,5245,4873,8952,1166,ITG,ITG1,19,Sicilia
2021-04-23,SAR,12845,5735,7110,7384,5461,ITG,ITG2,20,Sardegna
2021-04-08,ABR,7377,3332,4045,5065,2312,ITF,ITF1,13,Abruzzo
2021-01-04,EMR,7310,2526,4784,7310,0,ITH,ITH5,8,Emilia-Romagna
2021-01-18,PIE,6166,2048,4118,5917,249,ITC,ITC1,1,Piemonte
2021-01-30,LOM,12311,4564,7747,159,12152,ITC,ITC4,3,Lombardia
2021-02-04,TOS,4253,1594,2659,961,3292,ITI,ITI1,9,Toscana
2021-03-28,PAT,748,292,456,746,2,ITH,ITH2,4,Provincia Autonoma Trento
2021-02-23,FVG,2617,1252,1365,2437,180,ITH,ITH4,6,Friuli-Venezia Giulia
2021-05-28,BAS,3604,1802,1802,948,2656,ITF,ITF5,17,Basilicata
2021-02-14,PUG,787,348,439,663,124,ITF,ITF4,16,Puglia
2021-03-02,VEN,11483,4622,6861,8175,3308,ITH,ITH3,5,Veneto
2021-03-09,FVG,3861,1589,2272,1114,2747,ITH,ITH4,6,Friuli-Venezia Giulia
2021-01-09,LIG,1335,481,854,1335,0,ITC,ITC3,7,Liguria
2021-05-01,PAB,2104,1067,1037,1944,160,ITH,ITH1,4,Provincia Autonoma Bolzano / Bozen
2021-01-02,MAR,453,139,314,453,0,ITI,ITI3,11,Marche
2021-03-12,PAB,1664,734,930,1251,413,ITH,ITH1,4,Provincia Autonoma Bolzano / Bozen
2021-05-31,PIE,28782,13840,14942,20463,8319,ITC,ITC1,1,Piemonte
2021-01-18,PAT,643,154,489,588,55,ITH,ITH2,4,Provincia Autonoma Trento
2021-03-23,TOS,9093,4102,4991,6819,2274,ITI,ITI1,9,Toscana
2021-03-07,MAR,5179,2106,3073,4425,754,ITI,ITI3,11,Marche
2021-05-21,SIC,45864,21590,24274,24394,21470,ITG,ITG1,19,Sicilia
2021-02-13,LOM,6417,2441,3976,4941,1476,ITC,ITC4,3,Lombardia
2021-01-27,UMB,840,330,510,13,827,ITI,ITI2,10,Umbria
2021-01-03,EMR,2762,943,1819,2762,0,ITH,ITH5,8,Emilia-Romagna
2021-04-01,UMB,4374,1836,2538,2366,2008,ITI,ITI2,10,Umbria
2021-03-13,FVG,2935,1120,1815,1664,1271,ITH,ITH4,6,Friuli-Venezia Giulia
2021-01-01,PIE,1038,395,643,1038,0,ITC,ITC1,1,Piemonte
2021-01-13,LOM,26374,8052,18322,26374,0,ITC,ITC4,3,Lombardia
2021-05-12,TOS,34123,15545,18578,14160,19963,ITI,ITI1,9,Toscana
2021-05-08,MOL,2972,1453,1519,1728,1244,ITF,ITF2,14,Molise
2021-01-18,TOS,1119,636,483,1021,98,ITI,ITI1,9,Toscana
2021-05-16,EMR,25807,12152,13655,18703,7104,ITH,ITH5,8,Emilia-Romagna
2021-01-28,PUG,5472,2277,3195,471,5001,ITF,ITF4,16,Puglia
2021-05-21,LAZ,50255,23627,26628,37393,12862,ITI,ITI4,12,Lazio
2021-05-17,MAR,11853,5568,6285,7690,4163,ITI,ITI3,11,Marche
2021-04-04,LIG,756,366,390,507,249,ITC,ITC3,7,Liguria
2021-05-22,MOL,1307,706,601,1225,82,ITF,ITF2,14,Molise
2021-05-16,FVG,9942,4761,5181,8546,1396,ITH,ITH4,6,Friuli-Venezia Giulia
2021-05-26,VEN,30474,14846,15628,14307,16167,ITH,ITH3,5,Veneto
2021-03-13,EMR,16078,6308,9770,10765,5313,ITH,ITH5,8,Emilia-Romagna
2021-03-02,MOL,667,383,284,509,158,ITF,ITF2,14,Molise
2021-03-18,CAL,4399,2054,2345,2345,2054,ITF,ITF6,18,Calabria
2021-01-27,CAM,7738,3820,3918,162,7576,ITF,ITF3,15,Campania
2021-01-10,UMB,1070,277,793,1070,0,ITI,ITI2,10,Umbria
2021-03-22,BAS,1175,531,644,628,547,ITF,ITF5,17,Basilicata
2021-02-14,VDA,48,16,32,1,47,ITC,ITC2,2,Valle d'Aosta / Vallée d'Aoste
2021-02-13,LIG,1080,508,572,800,280,ITC,ITC3,7,Liguria
2021-05-25,BAS,4191,2107,2084,873,3318,ITF,ITF5,17,Basilicata
2021-05-02,EMR,25451,11593,13858,13464,11987,ITH,ITH5,8,Emilia-Romagna
2021-04-21,MOL,1862,788,1074,967,895,ITF,ITF2,14,Molise
2021-01-27,CAL,1457,733,724,396,1061,ITF,ITF6,18,Calabria
2021-01-12,ABR,1804,666,1138,1804,0,ITF,ITF1,13,Abruzzo
2021-03-18,CAM,12172,5378,6794,5984,6188,ITF,ITF3,15,Campania
2021-04-10,PAB,5391,2664,2727,4803,588,ITH,ITH1,4,Provincia Autonoma Bolzano / Bozen
2021-04-29,ABR,12669,5850,6819,9574,3095,ITF,ITF1,13,Abruzzo
2021-03-28,UMB,1096,442,654,1072,24,ITI,ITI2,10,Umbria
2021-01-30,SIC,7836,3569,4267,171,7665,ITG,ITG1,19,Sicilia
2021-02-04,LOM,27650,8072,19578,1996,25654,ITC,ITC4,3,Lombardia
2021-03-31,LIG,11841,5206,6635,9071,2770,ITC,ITC3,7,Liguria
2021-04-24,PUG,29239,13309,15930,25296,3943,ITF,ITF4,16,Puglia
2021-02-25,CAM,12425,4478,7947,11237,1188,ITF,ITF3,15,Campania
2021-04-11,EMR,15259,6926,8333,12214,3045,ITH,ITH5,8,Emilia-Romagna
2021-05-28,VDA,975,414,561,563,412,ITC,ITC2,2,Valle d'Aosta / Vallée d'Aoste
2021-04-04,LAZ,17463,8036,9427,12197,5266,ITI,ITI4,12,Lazio
2021-06-03,TOS,16509,7898,8611,13794,2715,ITI,ITI1,9,Toscana
2021-01-31,MOL,268,70,198,6,262,ITF,ITF2,14,Molise
2021-01-17,BAS,328,133,195,327,1,ITF,ITF5,17,Basilicata
2021-01-23,PIE,4257,1325,2932,879,3378,ITC,ITC1,1,Piemonte
2021-01-31,MAR,1920,770,1150,105,1815,ITI,ITI3,11,Marche
2021-02-19,PUG,4730,2009,2721,4338,392,ITF,ITF4,16,Puglia
2021-06-03,LIG,10811,5283,5528,6019,4792,ITC,ITC3,7,Liguria
2021-01-25,FVG,1583,567,1016,194,1389,ITH,ITH4,6,Friuli-Venezia Giulia
2021-01-17,ABR,187,59,128,180,7,ITF,ITF1,13,Abruzzo
2021-03-25,VDA,389,154,235,379,10,ITC,ITC2,2,Valle d'Aosta / Vallée d'Aoste
2021-02-16,TOS,9279,3339,5940,8558,721,ITI,ITI1,9,Toscana
2021-03-23,PIE,13073,5448,7625,6828,6245,ITC,ITC1,1,Piemonte
2021-04-19,PUG,27548,12781,14767,24502,3046,ITF,ITF4,16,Puglia
2021-04-06,UMB,5290,2169,3121,2901,2389,ITI,ITI2,10,Umbria
2021-04-28,FVG,7259,3201,4058,3795,3464,ITH,ITH4,6,Friuli-Venezia Giulia
2021-01-23,PAT,577,334,243,388,189,ITH,ITH2,4,Provincia Autonoma Trento
2021-04-09,LIG,12422,5554,6868,10683,1739,ITC,ITC3,7,Liguria
2021-02-20,LAZ,9205,4274,4931,8438,767,ITI,ITI4,12,Lazio
2021-04-09,LOM,52223,22292,29931,36230,15993,ITC,ITC4,3,Lombardia
2021-04-20,BAS,4033,1920,2113,2202,1831,ITF,ITF5,17,Basilicata
2021-04-19,PAB,1871,858,1013,1689,182,ITH,ITH1,4,Provincia Autonoma Bolzano / Bozen
2021-04-21,TOS,29599,12663,16936,17515,12084,ITI,ITI1,9,Toscana
2021-04-23,VEN,31150,13800,17350,22448,8702,ITH,ITH3,5,Veneto
2021-02-13,SAR,1456,565,891,1454,2,ITG,ITG2,20,Sardegna
2021-04-09,CAM,29846,13964,15882,23719,6127,ITF,ITF3,15,Campania
2021-05-05,PAT,4972,2575,2397,4689,283,ITH,ITH2,4,Provincia Autonoma Trento
2021-04-05,MOL,391,189,202,292,99,ITF,ITF2,14,Molise
2021-01-08,BAS,554,219,335,554,0,ITF,ITF5,17,Basilicata
2021-04-04,LOM,7613,3232,4381,3716,3897,ITC,ITC4,3,Lombardia
2021-02-11,EMR,4250,1416,2834,3410,840,ITH,ITH5,8,Emilia-Romagna
2021-02-18,SAR,1878,732,1146,1814,64,ITG,ITG2,20,Sardegna
2021-04-04,SIC,6825,3325,3500,5533,1292,ITG,ITG1,19,Sicilia
2021-01-07,PAB,917,327,590,917,0,ITH,ITH1,4,Provincia Autonoma Bolzano / Bozen
2021-01-07,PUG,5716,2457,3259,5716,0,ITF,ITF4,16,Puglia
2021-02-25,CAL,2875,1548,1327,2281,594,ITF,ITF6,18,Calabria
2020-12-28,LIG,80,30,50,80,0,ITC,ITC3,7,Liguria
2021-02-10,VDA,248,77,171,141,107,ITC,ITC2,2,Valle d'Aosta / Vallée d'Aoste
2021-02-09,MAR,124,42,82,46,78,ITI,ITI3,11,Marche
2021-05-05,PIE,32124,15032,17092,19115,13009,ITC,ITC1,1,Piemonte
2021-05-31,SAR,11065,5190,5875,8230,2835,ITG,ITG2,20,Sardegna
2021-02-18,VEN,5828,2455,3373,5764,64,ITH,ITH3,5,Veneto
2021-01-16,FVG,1230,360,870,1230,0,ITH,ITH4,6,Friuli-Venezia Giulia
2021-04-18,SAR,5127,2225,2902,2258,2869,ITG,ITG2,20,Sardegna
2021-03-07,PAB,114,13,101,9,105,ITH,ITH1,4,Provincia Autonoma Bolzano / Bozen
2021-02-19,VDA,292,102,190,268,24,ITC,ITC2,2,Valle d'Aosta / Vallée d'Aoste
2021-02-22,UMB,1859,778,1081,1773,86,ITI,ITI2,10,Umbria
2021-02-25,TOS,10634,4306,6328,9635,999,ITI,ITI1,9,Toscana
2021-04-18,VEN,17517,7255,10262,9945,7572,ITH,ITH3,5,Veneto
2021-03-31,MOL,2193,919,1274,1374,819,ITF,ITF2,14,Molise
2021-02-25,LIG,3455,1349,2106,3325,130,ITC,ITC3,7,Liguria
2021-03-08,EMR,12176,5063,7113,9502,2674,ITH,ITH5,8,Emilia-Romagna
2021-03-23,PAT,2444,943,1501,1704,740,ITH,ITH2,4,Provincia Autonoma Trento
2021-04-30,TOS,40096,17740,22356,20240,19856,ITI,ITI1,9,Toscana
2021-06-02,SIC,34866,16085,18781,27072,7794,ITG,ITG1,19,Sicilia
2021-01-22,CAM,1524,776,748,673,851,ITF,ITF3,15,Campania
2021-04-14,MAR,10214,4563,5651,9842,372,ITI,ITI3,11,Marche
2021-03-17,BAS,1452,609,843,27,1425,ITF,ITF5,17,Basilicata
2021-06-02,LAZ,42998,21328,21670,31644,11354,ITI,ITI4,12,Lazio
2021-05-04,CAL,16321,7519,8802,11695,4626,ITF,ITF6,18,Calabria
2021-06-03,MOL,2395,1160,1235,2101,294,ITF,ITF2,14,Molise
2021-04-09,MAR,9560,4189,5371,9360,200,ITI,ITI3,11,Marche
2021-05-28,FVG,9849,4571,5278,5922,3927,ITH,ITH4,6,Friuli-Venezia Giulia
2021-01-06,VEN,8132,2385,5747,8132,0,ITH,ITH3,5,Veneto
2021-01-22,CAL,658,274,384,656,2,ITF,ITF6,18,Calabria
2021-01-16,PUG,2507,1033,1474,2507,0,ITF,ITF4,16,Puglia
2021-01-02,PAB,91,48,43,91,0,ITH,ITH1,4,Provincia Autonoma Bolzano / Bozen
2021-03-25,FVG,5309,2261,3048,3176,2133,ITH,ITH4,6,Friuli-Venezia Giulia
2021-01-07,VDA,275,111,164,275,0,ITC,ITC2,2,Valle d'Aosta / Vallée d'Aoste
2021-04-01,PAT,2893,1227,1666,1800,1093,ITH,ITH2,4,Provincia Autonoma Trento
2021-03-06,CAL,8418,4335,4083,7626,792,ITF,ITF6,18,Calabria
2021-03-16,PUG,9867,4685,5182,3509,6358,ITF,ITF4,16,Puglia
2021-01-01,LOM,24,7,17,24,0,ITC,ITC4,3,Lombardia
2021-04-28,PUG,19720,8838,10882,14970,4750,ITF,ITF4,16,Puglia
2021-03-17,ABR,4539,1873,2666,2799,1740,ITF,ITF1,13,Abruzzo
2021-03-30,FVG,7093,3141,3952,6171,922,ITH,ITH4,6,Friuli-Venezia Giulia
2020-12-27,SIC,92,55,37,92,0,ITG,ITG1,19,Sicilia
2021-05-09,CAL,9666,4498,5168,6137,3529,ITF,ITF6,18,Calabria
2021-04-29,BAS,4831,2385,2446,4410,421,ITF,ITF5,17,Basilicata
2021-03-01,LAZ,17087,7346,9741,13202,3885,ITI,ITI4,12,Lazio
2021-04-24,VDA,722,400,322,555,167,ITC,ITC2,2,Valle d'Aosta / Vallée d'Aoste
2021-04-25,TOS,11054,5248,5806,8917,2137,ITI,ITI1,9,Toscana
2021-03-06,CAM,16308,6753,9555,10639,5669,ITF,ITF3,15,Campania
2021-03-01,SIC,12959,6119,6840,11304,1655,ITG,ITG1,19,Sicilia
2021-03-06,LOM,21308,9084,12224,16792,4516,ITC,ITC4,3,Lombardia
2021-04-20,EMR,22593,10392,12201,14242,8351,ITH,ITH5,8,Emilia-Romagna
2021-04-30,LIG,14346,6389,7957,5778,8568,ITC,ITC3,7,Liguria
2021-01-27,VDA,151,71,80,79,72,ITC,ITC2,2,Valle d'Aosta / Vallée d'Aoste
2021-04-22,BAS,5035,2345,2690,3433,1602,ITF,ITF5,17,Basilicata
2021-01-23,LAZ,7212,2869,4343,583,6629,ITI,ITI4,12,Lazio
2021-02-23,PAT,1108,395,713,897,211,ITH,ITH2,4,Provincia Autonoma Trento
2021-04-05,PUG,12690,6165,6525,12157,533,ITF,ITF4,16,Puglia
2020-12-27,VDA,20,9,11,20,0,ITC,ITC2,2,Valle d'Aosta / Vallée d'Aoste
2021-06-01,MAR,12050,6154,5896,9962,2088,ITI,ITI3,11,Marche
2021-02-28,LIG,1058,580,478,1049,9,ITC,ITC3,7,Liguria
2021-03-03,ABR,4622,1879,2743,3716,906,ITF,ITF1,13,Abruzzo
2021-01-18,FVG,1961,606,1355,1867,94,ITH,ITH4,6,Friuli-Venezia Giulia
2021-04-21,VEN,32316,13175,19141,16250,16066,ITH,ITH3,5,Veneto
2021-04-23,CAM,32299,15508,16791,23162,9137,ITF,ITF3,15,Campania
2021-04-22,ABR,6662,3193,3469,4981,1681,ITF,ITF1,13,Abruzzo
2021-01-04,PIE,5564,1679,3885,5564,0,ITC,ITC1,1,Piemonte
2021-04-28,PIE,25986,11711,14275,15954,10032,ITC,ITC1,1,Piemonte
2021-05-10,LOM,85183,40855,44328,63679,21504,ITC,ITC4,3,Lombardia
2021-02-17,BAS,1135,493,642,1059,76,ITF,ITF5,17,Basilicata
2021-05-15,TOS,29298,13830,15468,23558,5740,ITI,ITI1,9,Toscana
2021-05-25,PUG,33503,15236,18267,20465,13038,ITF,ITF4,16,Puglia
2021-03-01,VDA,181,66,115,147,34,ITC,ITC2,2,Valle d'Aosta / Vallée d'Aoste
2021-04-12,MAR,8567,3772,4795,8083,484,ITI,ITI3,11,Marche
2021-05-07,CAL,16084,7582,8502,9715,6369,ITF,ITF6,18,Calabria
2021-04-19,LIG,12807,5613,7194,8999,3808,ITC,ITC3,7,Liguria
2021-03-21,SAR,4030,1809,2221,2590,1440,ITG,ITG2,20,Sardegna
2021-02-23,PIE,9234,3713,5521,8653,581,ITC,ITC1,1,Piemonte
2021-03-04,CAM,14658,5352,9306,8765,5893,ITF,ITF3,15,Campania
2021-01-23,SIC,4335,2236,2099,216,4119,ITG,ITG1,19,Sicilia
2021-04-02,SIC,14009,6595,7414,9222,4787,ITG,ITG1,19,Sicilia
2021-02-06,PAT,574,298,276,433,141,ITH,ITH2,4,Provincia Autonoma Trento
2021-01-06,LAZ,5122,1961,3161,5122,0,ITI,ITI4,12,Lazio
2021-03-28,FVG,4814,2277,2537,4673,141,ITH,ITH4,6,Friuli-Venezia Giulia
2021-01-10,VDA,220,71,149,220,0,ITC,ITC2,2,Valle d'Aosta / Vallée d'Aoste
2021-03-19,PUG,7956,3652,4304,3411,4545,ITF,ITF4,16,Puglia
2021-01-07,MOL,598,209,389,598,0,ITF,ITF2,14,Molise
2021-05-07,UMB,10102,4694,5408,6903,3199,ITI,ITI2,10,Umbria
2021-05-24,CAM,31061,14890,16171,16173,14888,ITF,ITF3,15,Campania
2021-02-07,PAB,2361,1057,1304,14,2347,ITH,ITH1,4,Provincia Autonoma Bolzano / Bozen
2021-02-11,VEN,4012,1238,2774,3384,628,ITH,ITH3,5,Veneto
2021-01-30,SAR,3863,1392,2471,362,3501,ITG,ITG2,20,Sardegna
2021-04-11,PIE,20824,9317,11507,18663,2161,ITC,ITC1,1,Piemonte
2021-04-23,LOM,73369,33273,40096,56857,16512,ITC,ITC4,3,Lombardia
2021-02-02,MAR,1191,397,794,72,1119,ITI,ITI3,11,Marche
2021-01-04,PAT,870,227,643,870,0,ITH,ITH2,4,Provincia Autonoma Trento
2021-05-17,FVG,8768,4074,4694,6290,2478,ITH,ITH4,6,Friuli-Venezia Giulia
2021-04-28,TOS,19119,8187,10932,3830,15289,ITI,ITI1,9,Toscana
2021-05-24,CAL,17626,8780,8846,9957,7669,ITF,ITF6,18,Calabria
2021-03-18,UMB,2942,1164,1778,1704,1238,ITI,ITI2,10,Umbria
2021-05-08,PUG,53943,22810,31133,24308,29635,ITF,ITF4,16,Puglia
2021-02-18,TOS,8819,3284,5535,7924,895,ITI,ITI1,9,Toscana
2021-03-04,SAR,4002,1953,2049,2747,1255,ITG,ITG2,20,Sardegna
2021-02-17,ABR,2071,948,1123,1789,282,ITF,ITF1,13,Abruzzo
2021-02-06,PIE,7995,2666,5329,400,7595,ITC,ITC1,1,Piemonte
2021-01-06,SIC,6486,3412,3074,6486,0,ITG,ITG1,19,Sicilia
2021-03-09,PIE,13967,5429,8538,11625,2342,ITC,ITC1,1,Piemonte
2021-03-21,LOM,23574,8548,15026,18315,5259,ITC,ITC4,3,Lombardia
2021-04-20,UMB,5439,2356,3083,3492,1947,ITI,ITI2,10,Umbria
2021-04-05,BAS,723,233,490,421,302,ITF,ITF5,17,Basilicata
2021-03-27,EMR,21603,9045,12558,14697,6906,ITH,ITH5,8,Emilia-Romagna
2020-12-30,TOS,327,104,223,327,0,ITI,ITI1,9,Toscana
2021-05-21,UMB,8919,3635,5284,4116,4803,ITI,ITI2,10,Umbria
2021-01-13,SAR,573,178,395,573,0,ITG,ITG2,20,Sardegna
2021-05-24,LIG,11654,5421,6233,9175,2479,ITC,ITC3,7,Liguria
2021-01-21,PAB,953,442,511,139,814,ITH,ITH1,4,Provincia Autonoma Bolzano / Bozen
2021-05-25,VDA,1115,530,585,541,574,ITC,ITC2,2,Valle d'Aosta / Vallée d'Aoste
2021-01-25,VEN,6468,2075,4393,159,6309,ITH,ITH3,5,Veneto
2021-01-16,MAR,2005,723,1282,2005,0,ITI,ITI3,11,Marche
2021-01-22,EMR,1829,477,1352,1088,741,ITH,ITH5,8,Emilia-Romagna
2021-02-14,BAS,151,48,103,151,0,ITF,ITF5,17,Basilicata
2021-02-20,PIE,3833,1253,2580,3659,174,ITC,ITC1,1,Piemonte
2021-03-04,LOM,29370,12134,17236,20242,9128,ITC,ITC4,3,Lombardia
2021-02-10,SIC,4420,1813,2607,3999,421,ITG,ITG1,19,Sicilia
2021-01-08,CAL,2136,1024,1112,2136,0,ITF,ITF6,18,Calabria
2021-05-07,CAM,59717,29182,30535,43773,15944,ITF,ITF3,15,Campania
2021-04-13,EMR,23644,11086,12558,19343,4301,ITH,ITH5,8,Emilia-Romagna
2021-05-04,UMB,5531,2543,2988,2410,3121,ITI,ITI2,10,Umbria
2021-04-01,LAZ,28403,13046,15357,21263,7140,ITI,ITI4,12,Lazio
2021-04-05,ABR,2693,1147,1546,1813,880,ITF,ITF1,13,Abruzzo
2021-05-07,LIG,13566,6020,7546,5782,7784,ITC,ITC3,7,Liguria
2021-05-08,VDA,904,540,364,526,378,ITC,ITC2,2,Valle d'Aosta / Vallée d'Aoste
2021-03-03,BAS,1745,815,930,1186,559,ITF,ITF5,17,Basilicata
2021-04-02,MOL,1453,708,745,676,777,ITF,ITF2,14,Molise
2021-05-02,PAT,3512,1955,1557,3475,37,ITH,ITH2,4,Provincia Autonoma Trento
2021-02-27,CAL,3989,2053,1936,3610,379,ITF,ITF6,18,Calabria
2021-04-01,SIC,14403,6676,7727,9689,4714,ITG,ITG1,19,Sicilia
2021-03-01,UMB,1503,774,729,1389,114,ITI,ITI2,10,Umbria
2021-04-20,VEN,22406,9487,12919,8405,14001,ITH,ITH3,5,Veneto
2021-02-08,EMR,5227,1532,3695,2315,2912,ITH,ITH5,8,Emilia-Romagna
2021-04-15,LAZ,31907,14300,17607,21103,10804,ITI,ITI4,12,Lazio
2021-02-22,EMR,7481,3091,4390,7209,272,ITH,ITH5,8,Emilia-Romagna
2021-01-31,BAS,77,24,53,0,77,ITF,ITF5,17,Basilicata
2021-02-01,TOS,5509,1958,3551,521,4988,ITI,ITI1,9,Toscana
2021-02-10,LAZ,8187,3398,4789,4850,3337,ITI,ITI4,12,Lazio
2021-03-13,PAT,830,380,450,782,48,ITH,ITH2,4,Provincia Autonoma Trento
2021-04-05,VDA,461,222,239,457,4,ITC,ITC2,2,Valle d'Aosta / Vallée d'Aoste
2021-02-11,MOL,293,133,160,257,36,ITF,ITF2,14,Molise
2021-01-31,ABR,1501,487,1014,286,1215,ITF,ITF1,13,Abruzzo
2021-05-28,SAR,17308,8259,9049,13438,3870,ITG,ITG2,20,Sardegna
2021-06-01,PUG,32441,15978,16463,20817,11624,ITF,ITF4,16,Puglia
2021-01-18,CAM,957,399,558,713,244,ITF,ITF3,15,Campania
2021-02-24,BAS,1803,743,1060,1734,69,ITF,ITF5,17,Basilicata
2021-04-26,LIG,10446,4914,5532,7820,2626,ITC,ITC3,7,Liguria
2021-05-12,LAZ,47398,21472,25926,30879,16519,ITI,ITI4,12,Lazio
2021-04-05,MAR,5688,2355,3333,4419,1269,ITI,ITI3,11,Marche
2021-03-04,EMR,16435,5345,11090,13423,3012,ITH,ITH5,8,Emilia-Romagna
2021-04-30,CAL,14916,7319,7597,10597,4319,ITF,ITF6,18,Calabria
2021-02-24,ABR,3305,1441,1864,3129,176,ITF,ITF1,13,Abruzzo
2021-03-10,MOL,1737,720,1017,1687,50,ITF,ITF2,14,Molise
2021-03-04,FVG,3446,1595,1851,2788,658,ITH,ITH4,6,Friuli-Venezia Giulia
2021-03-02,PIE,11202,4506,6696,10386,816,ITC,ITC1,1,Piemonte
2021-03-14,LOM,14874,5349,9525,11590,3284,ITC,ITC4,3,Lombardia
2021-02-21,LIG,869,491,378,865,4,ITC,ITC3,7,Liguria
2021-03-29,PUG,12905,6012,6893,6169,6736,ITF,ITF4,16,Puglia
2021-01-09,TOS,4485,1596,2889,4485,0,ITI,ITI1,9,Toscana
2021-04-14,VEN,15880,6882,8998,9254,6626,ITH,ITH3,5,Veneto
2021-05-31,UMB,5760,2812,2948,4910,850,ITI,ITI2,10,Umbria
2021-01-23,SAR,60,22,38,0,60,ITG,ITG2,20,Sardegna
2021-04-30,CAM,42231,20132,22099,25783,16448,ITF,ITF3,15,Campania
2021-01-30,LAZ,7009,2891,4118,807,6202,ITI,ITI4,12,Lazio
2021-02-18,UMB,1496,582,914,1030,466,ITI,ITI2,10,Umbria
2021-03-03,PAB,1179,393,786,1166,13,ITH,ITH1,4,Provincia Autonoma Bolzano / Bozen
2021-05-24,FVG,11010,5268,5742,7516,3494,ITH,ITH4,6,Friuli-Venezia Giulia
2021-05-15,PUG,42905,18699,24206,23300,19605,ITF,ITF4,16,Puglia
2021-05-31,VEN,31102,15917,15185,21586,9516,ITH,ITH3,5,Veneto
2021-05-16,ABR,9580,4139,5441,5764,3816,ITF,ITF1,13,Abruzzo
2021-05-24,EMR,29586,13494,16092,18369,11217,ITH,ITH5,8,Emilia-Romagna
2021-04-15,VDA,810,377,433,671,139,ITC,ITC2,2,Valle d'Aosta / Vallée d'Aoste
2021-03-19,MAR,3835,1597,2238,339,3496,ITI,ITI3,11,Marche
2021-03-28,SAR,4620,1815,2805,4541,79,ITG,ITG2,20,Sardegna
2021-02-04,LIG,2817,986,1831,179,2638,ITC,ITC3,7,Liguria
2021-03-28,VEN,31250,13586,17664,27614,3636,ITH,ITH3,5,Veneto
2021-03-21,FVG,2602,937,1665,2193,409,ITH,ITH4,6,Friuli-Venezia Giulia
2021-01-13,LAZ,5691,2150,3541,5691,0,ITI,ITI4,12,Lazio
2021-03-02,PAT,1304,440,864,928,376,ITH,ITH2,4,Provincia Autonoma Trento
2021-01-18,CAL,1265,570,695,1044,221,ITF,ITF6,18,Calabria
2021-05-17,CAM,49217,21604,27613,24078,25139,ITF,ITF3,15,Campania
2021-05-27,PAB,6049,3178,2871,4045,2004,ITH,ITH1,4,Provincia Autonoma Bolzano / Bozen
2021-03-12,PUG,13933,6109,7824,10008,3925,ITF,ITF4,16,Puglia
2021-05-14,UMB,5240,2435,2805,3435,1805,ITI,ITI2,10,Umbria
2021-05-13,MOL,3037,1409,1628,2580,457,ITF,ITF2,14,Molise
2021-02-14,PAB,297,130,167,297,0,ITH,ITH1,4,Provincia Autonoma Bolzano / Bozen
2021-02-01,UMB,1285,342,943,48,1237,ITI,ITI2,10,Umbria
2021-05-12,SIC,36859,17351,19508,21914,14945,ITG,ITG1,19,Sicilia
2021-02-04,CAM,7943,3429,4514,1308,6635,ITF,ITF3,15,Campania
2021-03-13,BAS,1796,889,907,751,1045,ITF,ITF5,17,Basilicata
2021-05-17,LOM,94513,45271,49242,30205,64308,ITC,ITC4,3,Lombardia
2021-02-07,BAS,373,159,214,49,324,ITF,ITF5,17,Basilicata
2021-01-29,EMR,10415,3497,6918,290,10125,ITH,ITH5,8,Emilia-Romagna
2021-04-25,LAZ,24512,11241,13271,16702,7810,ITI,ITI4,12,Lazio
2021-03-02,MAR,4953,1941,3012,4387,566,ITI,ITI3,11,Marche
2021-02-13,PIE,4153,1334,2819,2931,1222,ITC,ITC1,1,Piemonte
2021-03-11,SAR,6036,2726,3310,4835,1201,ITG,ITG2,20,Sardegna
2021-02-25,LOM,15230,6314,8916,13670,1560,ITC,ITC4,3,Lombardia
2021-02-21,MOL,573,227,346,571,2,ITF,ITF2,14,Molise
2021-03-29,VDA,493,233,260,453,40,ITC,ITC2,2,Valle d'Aosta / Vallée d'Aoste
2021-03-27,CAL,8570,3882,4688,4588,3982,ITF,ITF6,18,Calabria
2021-01-21,ABR,157,47,110,157,0,ITF,ITF1,13,Abruzzo
2021-04-04,TOS,13910,6601,7309,13657,253,ITI,ITI1,9,Toscana
2021-02-15,FVG,2453,911,1542,2201,252,ITH,ITH4,6,Friuli-Venezia Giulia
2021-02-20,SIC,7242,3726,3516,7000,242,ITG,ITG1,19,Sicilia
2021-01-18,LIG,2137,745,1392,1980,157,ITC,ITC3,7,Liguria
2021-03-11,VEN,19701,8771,10930,14127,5574,ITH,ITH3,5,Veneto
2021-02-13,PAT,537,333,204,172,365,ITH,ITH2,4,Provincia Autonoma Trento
2021-05-26,PIE,32271,14771,17500,15576,16695,ITC,ITC1,1,Piemonte
2021-05-22,MAR,11933,5718,6215,7485,4448,ITI,ITI3,11,Marche
2021-02-23,PUG,9349,4422,4927,8874,475,ITF,ITF4,16,Puglia
2021-01-06,SAR,1615,549,1066,1615,0,ITG,ITG2,20,Sardegna
2021-01-28,PAB,871,308,563,10,861,ITH,ITH1,4,Provincia Autonoma Bolzano / Bozen
2021-05-20,BAS,5855,2964,2891,2890,2965,ITF,ITF5,17,Basilicata
2021-04-26,MOL,1157,521,636,826,331,ITF,ITF2,14,Molise
2021-06-01,VDA,871,469,402,518,353,ITC,ITC2,2,Valle d'Aosta / Vallée d'Aoste
2021-05-26,PAT,3902,1837,2065,1219,2683,ITH,ITH2,4,Provincia Autonoma Trento
2021-04-20,FVG,7106,3059,4047,3203,3903,ITH,ITH4,6,Friuli-Venezia Giulia
2021-04-25,SIC,21354,10185,11169,16376,4978,ITG,ITG1,19,Sicilia
2021-04-30,LOM,116904,54643,62261,89710,27194,ITC,ITC4,3,Lombardia
2021-01-01,CAM,919,506,413,919,0,ITF,ITF3,15,Campania
2021-05-14,VEN,46316,22033,24283,25655,20661,ITH,ITH3,5,Veneto
2021-04-08,SIC,16795,8287,8508,8312,8483,ITG,ITG1,19,Sicilia
2021-05-07,FVG,10566,4830,5736,7087,3479,ITH,ITH4,6,Friuli-Venezia Giulia
2021-02-15,EMR,2902,850,2052,2777,125,ITH,ITH5,8,Emilia-Romagna
2021-03-18,TOS,9970,3981,5989,6005,3965,ITI,ITI1,9,Toscana
2021-04-13,CAL,6777,3268,3509,5467,1310,ITF,ITF6,18,Calabria
2021-02-22,SAR,1639,949,690,1411,228,ITG,ITG2,20,Sardegna
2021-02-07,ABR,777,307,470,201,576,ITF,ITF1,13,Abruzzo
2021-01-27,PIE,4196,1453,2743,999,3197,ITC,ITC1,1,Piemonte
2021-02-08,LOM,10079,2918,7161,2133,7946,ITC,ITC4,3,Lombardia
2021-02-04,MOL,758,295,463,77,681,ITF,ITF2,14,Molise
2021-03-12,VDA,531,175,356,305,226,ITC,ITC2,2,Valle d'Aosta / Vallée d'Aoste
2021-05-20,ABR,12546,5784,6762,7328,5218,ITF,ITF1,13,Abruzzo
2021-05-10,PAB,3018,1300,1718,1413,1605,ITH,ITH1,4,Provincia Autonoma Bolzano / Bozen
2021-05-09,PIE,27051,12897,14154,13444,13607,ITC,ITC1,1,Piemonte
2021-01-27,PAT,802,277,525,91,711,ITH,ITH2,4,Provincia Autonoma Trento
2021-02-03,SIC,6094,2853,3241,752,5342,ITG,ITG1,19,Sicilia
2020-12-27,LAZ,274,132,142,274,0,ITI,ITI4,12,Lazio
2021-04-27,UMB,5665,2403,3262,3088,2577,ITI,ITI2,10,Umbria
2021-03-16,CAM,8086,3519,4567,3772,4314,ITF,ITF3,15,Campania
2021-03-16,LAZ,13538,5732,7806,7094,6444,ITI,ITI4,12,Lazio
2021-05-30,BAS,2771,1420,1351,921,1850,ITF,ITF5,17,Basilicata
2021-05-02,VDA,765,345,420,605,160,ITC,ITC2,2,Valle d'Aosta / Vallée d'Aoste
2021-04-03,BAS,1807,749,1058,1472,335,ITF,ITF5,17,Basilicata
2021-03-09,LAZ,20873,8939,11934,15676,5197,ITI,ITI4,12,Lazio
2021-01-08,VDA,299,130,169,299,0,ITC,ITC2,2,Valle d'Aosta / Vallée d'Aoste
2021-05-20,PUG,32692,14537,18155,20619,12073,ITF,ITF4,16,Puglia
2021-01-11,LAZ,5531,2105,3426,5531,0,ITI,ITI4,12,Lazio
2021-05-03,TOS,11933,5510,6423,10614,1319,ITI,ITI1,9,Toscana
2021-03-06,VDA,22,4,18,22,0,ITC,ITC2,2,Valle d'Aosta / Vallée d'Aoste
2021-01-25,CAM,5745,2927,2818,164,5581,ITF,ITF3,15,Campania
2021-02-01,CAL,2497,1193,1304,244,2253,ITF,ITF6,18,Calabria
2021-01-12,MOL,336,114,222,336,0,ITF,ITF2,14,Molise
2021-03-23,CAM,15335,7055,8280,12822,2513,ITF,ITF3,15,Campania
2021-05-19,CAM,51018,22495,28523,34521,16497,ITF,ITF3,15,Campania
2021-05-06,PUG,39298,17152,22146,19654,19644,ITF,ITF4,16,Puglia
2021-02-05,BAS,984,443,541,64,920,ITF,ITF5,17,Basilicata
2021-05-26,CAL,18483,9136,9347,10278,8205,ITF,ITF6,18,Calabria
2021-02-24,MOL,666,278,388,333,333,ITF,ITF2,14,Molise
2021-05-16,BAS,4969,2466,2503,2858,2111,ITF,ITF5,17,Basilicata
2021-03-30,CAL,6145,2637,3508,3439,2706,ITF,ITF6,18,Calabria
2021-05-05,LAZ,46706,21424,25282,30901,15805,ITI,ITI4,12,Lazio
2021-03-13,VDA,145,86,59,145,0,ITC,ITC2,2,Valle d'Aosta / Vallée d'Aoste
2021-03-02,LAZ,16987,7429,9558,13053,3934,ITI,ITI4,12,Lazio
2021-05-23,BAS,4572,2338,2234,1590,2982,ITF,ITF5,17,Basilicata
2021-01-15,VDA,218,82,136,218,0,ITC,ITC2,2,Valle d'Aosta / Vallée d'Aoste
2021-04-28,LAZ,32854,14998,17856,21307,11547,ITI,ITI4,12,Lazio
2021-05-19,CAL,18448,9139,9309,11429,7019,ITF,ITF6,18,Calabria
2021-05-12,CAM,40796,19914,20882,31657,9139,ITF,ITF3,15,Campania
2021-03-23,CAL,5253,2459,2794,3444,1809,ITF,ITF6,18,Calabria
2021-03-03,MOL,672,316,356,590,82,ITF,ITF2,14,Molise
2021-05-13,PUG,38322,17045,21277,21288,17034,ITF,ITF4,16,Puglia
2021-01-05,MOL,449,180,269,449,0,ITF,ITF2,14,Molise
2021-03-17,PUG,10345,4702,5643,4171,6174,ITF,ITF4,16,Puglia
2021-03-27,BAS,2230,851,1379,1815,415,ITF,ITF5,17,Basilicata
2021-04-28,LOM,95566,43595,51971,68728,26838,ITC,ITC4,3,Lombardia
2021-03-16,LOM,25472,10114,15358,16420,9052,ITC,ITC4,3,Lombardia
2021-01-23,EMR,2447,870,1577,443,2004,ITH,ITH5,8,Emilia-Romagna
2021-05-12,LOM,87211,41615,45596,59781,27430,ITC,ITC4,3,Lombardia
2021-05-17,TOS,29477,14631,14846,20806,8671,ITI,ITI1,9,Toscana
2021-03-21,TOS,3231,1573,1658,1798,1433,ITI,ITI1,9,Toscana
2021-01-22,VDA,56,21,35,20,36,ITC,ITC2,2,Valle d'Aosta / Vallée d'Aoste
2021-02-09,PUG,3840,1570,2270,2168,1672,ITF,ITF4,16,Puglia
2021-01-23,TOS,3949,1354,2595,640,3309,ITI,ITI1,9,Toscana
2021-03-24,PUG,13014,6005,7009,5731,7283,ITF,ITF4,16,Puglia
2021-01-26,PUG,5360,2397,2963,570,4790,ITF,ITF4,16,Puglia
2021-05-12,CAL,16319,7923,8396,10892,5427,ITF,ITF6,18,Calabria
2021-05-05,CAM,51131,24842,26289,44755,6376,ITF,ITF3,15,Campania
2021-01-25,LAZ,8111,3246,4865,770,7341,ITI,ITI4,12,Lazio
2021-03-09,LOM,33214,12856,20358,25814,7400,ITC,ITC4,3,Lombardia
2021-05-05,LOM,87785,41868,45917,72546,15239,ITC,ITC4,3,Lombardia
2021-03-28,TOS,6212,2808,3404,5958,254,ITI,ITI1,9,Toscana
2021-01-30,TOS,4622,1622,3000,198,4424,ITI,ITI1,9,Toscana
2021-05-10,TOS,26138,12350,13788,15521,10617,ITI,ITI1,9,Toscana
2021-01-18,LAZ,6267,2557,3710,5289,978,ITI,ITI4,12,Lazio
2021-04-25,UMB,4364,1685,2679,4282,82,ITI,ITI2,10,Umbria
2021-03-14,TOS,7173,2561,4612,3238,3935,ITI,ITI1,9,Toscana
2021-03-31,PUG,14050,6357,7693,8494,5556,ITF,ITF4,16,Puglia
2021-02-02,PUG,4343,1845,2498,593,3750,ITF,ITF4,16,Puglia
2021-01-18,LOM,9146,2969,6177,8171,975,ITC,ITC4,3,Lombardia
2021-01-07,BAS,640,319,321,640,0,ITF,ITF5,17,Basilicata
2021-03-23,LOM,42514,15405,27109,29642,12872,ITC,ITC4,3,Lombardia
2021-03-06,UMB,4267,1110,3157,4124,143,ITI,ITI2,10,Umbria
2021-05-02,SIC,24654,11444,13210,18053,6601,ITG,ITG1,19,Sicilia
2021-05-02,UMB,3787,1868,1919,1333,2454,ITI,ITI2,10,Umbria
2021-02-06,TOS,4527,1550,2977,1294,3233,ITI,ITI1,9,Toscana
2021-05-12,LIG,11895,5331,6564,6555,5340,ITC,ITC3,7,Liguria
2021-04-27,FVG,8077,3703,4374,3619,4458,ITH,ITH4,6,Friuli-Venezia Giulia
2021-01-25,LOM,7012,2367,4645,473,6539,ITC,ITC4,3,Lombardia
2021-02-01,LOM,16055,5315,10740,305,15750,ITC,ITC4,3,Lombardia
2020-12-27,CAL,281,156,125,281,0,ITF,ITF6,18,Calabria
2021-03-13,UMB,1731,524,1207,1486,245,ITI,ITI2,10,Umbria
2021-01-15,UMB,701,215,486,701,0,ITI,ITI2,10,Umbria
2021-05-09,UMB,5765,2757,3008,5374,391,ITI,ITI2,10,Umbria
2021-05-19,LIG,13526,5946,7580,10407,3119,ITC,ITC3,7,Liguria
2021-03-23,LIG,9036,4082,4954,5827,3209,ITC,ITC3,7,Liguria
2021-05-28,VEN,45092,22122,22970,24665,20427,ITH,ITH3,5,Veneto
2021-05-12,MAR,10421,4684,5737,4921,5500,ITI,ITI3,11,Marche
2021-05-16,SAR,8177,3812,4365,6017,2160,ITG,ITG2,20,Sardegna
2021-05-16,SIC,33110,16124,16986,21784,11326,ITG,ITG1,19,Sicilia
2021-02-15,CAL,1140,539,601,991,149,ITF,ITF6,18,Calabria
2021-02-19,BAS,1622,737,885,1560,62,ITF,ITF5,17,Basilicata
2021-01-22,UMB,276,105,171,32,244,ITI,ITI2,10,Umbria
2021-03-20,SIC,18811,9029,9782,13486,5325,ITG,ITG1,19,Sicilia
2021-02-08,CAM,5113,2449,2664,4310,803,ITF,ITF3,15,Campania
2021-03-20,UMB,2298,833,1465,2273,25,ITI,ITI2,10,Umbria
2021-02-01,LIG,2557,922,1635,90,2467,ITC,ITC3,7,Liguria
2021-05-26,LIG,16153,8009,8144,11999,4154,ITC,ITC3,7,Liguria
2021-03-30,LIG,12142,5378,6764,8753,3389,ITC,ITC3,7,Liguria
2021-05-21,VEN,44529,21903,22626,20850,23679,ITH,ITH3,5,Veneto
2021-02-12,BAS,775,332,443,744,31,ITF,ITF5,17,Basilicata
2021-04-10,BAS,1032,378,654,950,82,ITF,ITF5,17,Basilicata
2021-02-01,CAM,3985,1813,2172,110,3875,ITF,ITF3,15,Campania
2021-04-06,CAL,7463,3372,4091,4178,3285,ITF,ITF6,18,Calabria
2021-05-09,SIC,28136,13161,14975,19865,8271,ITG,ITG1,19,Sicilia
2021-03-30,CAM,21729,10272,11457,18771,2958,ITF,ITF3,15,Campania
2021-01-06,EMR,8285,2954,5331,8285,0,ITH,ITH5,8,Emilia-Romagna
2021-04-30,EMR,36524,16743,19781,21739,14785,ITH,ITH5,8,Emilia-Romagna
2021-01-11,UMB,1315,346,969,1315,0,ITI,ITI2,10,Umbria
2021-05-05,UMB,7173,3284,3889,3877,3296,ITI,ITI2,10,Umbria
2021-04-30,FVG,7305,3218,4087,3692,3613,ITH,ITH4,6,Friuli-Venezia Giulia
2021-02-19,MAR,1962,712,1250,1827,135,ITI,ITI3,11,Marche
2021-05-05,SIC,26314,12182,14132,16710,9604,ITG,ITG1,19,Sicilia
2021-03-19,LIG,5294,2234,3060,2149,3145,ITC,ITC3,7,Liguria
2021-02-04,PIE,10203,3339,6864,588,9615,ITC,ITC1,1,Piemonte
2021-03-26,PAT,3156,1226,1930,2557,599,ITH,ITH2,4,Provincia Autonoma Trento
2021-01-28,LOM,12191,3692,8499,771,11420,ITC,ITC4,3,Lombardia
2021-03-11,EMR,17256,7136,10120,11406,5850,ITH,ITH5,8,Emilia-Romagna
2021-03-16,UMB,3538,1454,2084,1911,1627,ITI,ITI2,10,Umbria
2020-12-28,SAR,65,25,40,65,0,ITG,ITG2,20,Sardegna
2020-12-31,MAR,385,180,205,385,0,ITI,ITI3,11,Marche
2021-01-05,PAB,830,286,544,830,0,ITH,ITH1,4,Provincia Autonoma Bolzano / Bozen
2021-02-04,PAT,975,304,671,421,554,ITH,ITH2,4,Provincia Autonoma Trento
2021-05-08,LIG,7527,3332,4195,2314,5213,ITC,ITC3,7,Liguria
2021-01-09,VEN,7927,2539,5388,7927,0,ITH,ITH3,5,Veneto
2021-05-20,PAB,4696,2314,2382,3240,1456,ITH,ITH1,4,Provincia Autonoma Bolzano / Bozen
2021-02-11,LIG,1979,767,1212,1103,876,ITC,ITC3,7,Liguria
2021-03-23,SAR,6157,2640,3517,5079,1078,ITG,ITG2,20,Sardegna
2021-05-22,LIG,6551,3195,3356,4943,1608,ITC,ITC3,7,Liguria
2021-04-16,EMR,28854,13564,15290,20020,8834,ITH,ITH5,8,Emilia-Romagna
2021-03-20,ABR,4788,2197,2591,2619,2169,ITF,ITF1,13,Abruzzo
2021-04-04,VEN,7775,3531,4244,6624,1151,ITH,ITH3,5,Veneto
2020-12-27,BAS,106,41,65,106,0,ITF,ITF5,17,Basilicata
2021-05-15,MAR,13965,6376,7589,8076,5889,ITI,ITI3,11,Marche
2021-02-04,FVG,2725,808,1917,35,2690,ITH,ITH4,6,Friuli-Venezia Giulia
2021-04-18,LAZ,23773,10556,13217,16139,7634,ITI,ITI4,12,Lazio
2021-01-25,SIC,7512,3695,3817,305,7207,ITG,ITG1,19,Sicilia
2021-01-25,UMB,648,323,325,5,643,ITI,ITI2,10,Umbria
2021-05-19,SIC,42691,20585,22106,28388,14303,ITG,ITG1,19,Sicilia
2021-03-31,PAB,1832,694,1138,821,1011,ITH,ITH1,4,Provincia Autonoma Bolzano / Bozen
2021-05-24,VEN,32604,16106,16498,7742,24862,ITH,ITH3,5,Veneto
2021-04-02,LIG,11670,5116,6554,9184,2486,ITC,ITC3,7,Liguria
2021-05-12,SAR,10775,5033,5742,7696,3079,ITG,ITG2,20,Sardegna
2021-02-25,EMR,9228,3497,5731,8274,954,ITH,ITH5,8,Emilia-Romagna
2021-04-30,PIE,31770,14277,17493,18444,13326,ITC,ITC1,1,Piemonte
2021-01-29,ABR,1387,449,938,74,1313,ITF,ITF1,13,Abruzzo
2021-04-22,VDA,1067,449,618,684,383,ITC,ITC2,2,Valle d'Aosta / Vallée d'Aoste
2021-02-11,CAL,2329,1040,1289,1082,1247,ITF,ITF6,18,Calabria
2021-03-16,SIC,9780,4363,5417,3662,6118,ITG,ITG1,19,Sicilia
2021-02-15,BAS,622,232,390,580,42,ITF,ITF5,17,Basilicata
2021-02-04,MAR,2341,809,1532,112,2229,ITI,ITI3,11,Marche
2021-04-06,SAR,7446,3113,4333,5018,2428,ITG,ITG2,20,Sardegna
2021-04-30,PAT,4911,2397,2514,4766,145,ITH,ITH2,4,Provincia Autonoma Trento
2021-03-11,PIE,13773,5075,8698,10676,3097,ITC,ITC1,1,Piemonte
2021-06-03,PAB,3882,2051,1831,3083,799,ITH,ITH1,4,Provincia Autonoma Bolzano / Bozen
2021-03-03,VDA,255,118,137,187,68,ITC,ITC2,2,Valle d'Aosta / Vallée d'Aoste
2021-05-23,CAL,11365,5547,5818,7033,4332,ITF,ITF6,18,Calabria
2021-03-19,ABR,5794,2584,3210,2774,3020,ITF,ITF1,13,Abruzzo
2021-02-08,SIC,4086,1760,2326,2129,1957,ITG,ITG1,19,Sicilia
2021-05-27,BAS,3598,1852,1746,1073,2525,ITF,ITF5,17,Basilicata
2021-04-19,MOL,1827,842,985,1049,778,ITF,ITF2,14,Molise
2021-03-20,CAM,13882,6429,7453,10143,3739,ITF,ITF3,15,Campania
2021-04-14,PAB,3593,1645,1948,3502,91,ITH,ITH1,4,Provincia Autonoma Bolzano / Bozen
2021-02-01,SAR,1524,605,919,225,1299,ITG,ITG2,20,Sardegna
2021-05-02,LAZ,32619,14333,18286,23258,9361,ITI,ITI4,12,Lazio
2021-03-26,MAR,6331,2606,3725,3523,2808,ITI,ITI3,11,Marche
2021-05-26,SAR,14287,7096,7191,9809,4478,ITG,ITG2,20,Sardegna
2021-02-13,VEN,3267,1474,1793,3247,20,ITH,ITH3,5,Veneto
2021-01-20,PIE,6616,2089,4527,5899,717,ITC,ITC1,1,Piemonte
2021-03-11,PAT,2295,851,1444,1473,822,ITH,ITH2,4,Provincia Autonoma Trento
2021-05-08,ABR,10303,4877,5426,6468,3835,ITF,ITF1,13,Abruzzo
2021-01-12,VDA,302,72,230,302,0,ITC,ITC2,2,Valle d'Aosta / Vallée d'Aoste
2021-02-27,LAZ,11427,4268,7159,10472,955,ITI,ITI4,12,Lazio
2021-05-10,PUG,37351,16470,20881,19499,17852,ITF,ITF4,16,Puglia
2021-02-28,MOL,831,333,498,789,42,ITF,ITF2,14,Molise
2021-05-09,CAM,43168,20271,22897,32078,11090,ITF,ITF3,15,Campania
2021-03-30,SIC,14596,6759,7837,9771,4825,ITG,ITG1,19,Sicilia
2021-04-15,EMR,29017,13807,15210,19347,9670,ITH,ITH5,8,Emilia-Romagna
2021-01-14,ABR,530,189,341,530,0,ITF,ITF1,13,Abruzzo
2021-03-11,FVG,3355,1413,1942,1605,1750,ITH,ITH4,6,Friuli-Venezia Giulia
2021-02-23,PAB,769,324,445,763,6,ITH,ITH1,4,Provincia Autonoma Bolzano / Bozen
2021-01-20,PAT,291,73,218,279,12,ITH,ITH2,4,Provincia Autonoma Trento
2021-04-25,LOM,51460,23604,27856,46735,4725,ITC,ITC4,3,Lombardia
2021-03-13,LAZ,21457,8432,13025,15563,5894,ITI,ITI4,12,Lazio
2021-03-17,VDA,433,185,248,273,160,ITC,ITC2,2,Valle d'Aosta / Vallée d'Aoste
2020-12-27,SAR,65,34,31,65,0,ITG,ITG2,20,Sardegna
2021-04-04,PUG,5945,2953,2992,5940,5,ITF,ITF4,16,Puglia
2021-03-25,PIE,17062,7203,9859,8423,8639,ITC,ITC1,1,Piemonte
2021-01-09,MOL,450,152,298,450,0,ITF,ITF2,14,Molise
2021-03-21,PUG,2692,1226,1466,588,2104,ITF,ITF4,16,Puglia
2021-03-05,ABR,5344,1956,3388,4647,697,ITF,ITF1,13,Abruzzo
2021-05-14,TOS,33252,15382,17870,20633,12619,ITI,ITI1,9,Toscana
2021-01-20,FVG,748,320,428,13,735,ITH,ITH4,6,Friuli-Venezia Giulia
2021-01-26,VDA,139,48,91,0,139,ITC,ITC2,2,Valle d'Aosta / Vallée d'Aoste
2021-01-04,PAB,508,201,307,508,0,ITH,ITH1,4,Provincia Autonoma Bolzano / Bozen
2021-02-15,SAR,958,349,609,927,31,ITG,ITG2,20,Sardegna
2021-01-22,LAZ,4002,1633,2369,487,3515,ITI,ITI4,12,Lazio
2021-05-24,PUG,34860,16145,18715,24347,10513,ITF,ITF4,16,Puglia
2021-01-20,EMR,1325,270,1055,1324,1,ITH,ITH5,8,Emilia-Romagna
2021-02-03,PIE,10199,3303,6896,611,9588,ITC,ITC1,1,Piemonte
2021-01-30,PUG,5528,2515,3013,411,5117,ITF,ITF4,16,Puglia
2021-04-24,ABR,8709,3970,4739,7179,1530,ITF,ITF1,13,Abruzzo
2021-03-10,EMR,18726,7682,11044,13084,5642,ITH,ITH5,8,Emilia-Romagna
2021-05-30,ABR,8564,4067,4497,5350,3214,ITF,ITF1,13,Abruzzo
2021-03-02,SIC,14867,6359,8508,12058,2809,ITG,ITG1,19,Sicilia
2021-04-03,ABR,5086,2222,2864,3490,1596,ITF,ITF1,13,Abruzzo
2021-01-04,SIC,8408,4195,4213,8408,0,ITG,ITG1,19,Sicilia
2021-02-11,PIE,6764,2107,4657,3006,3758,ITC,ITC1,1,Piemonte
2021-04-09,PIE,25847,11387,14460,21338,4509,ITC,ITC1,1,Piemonte
2021-04-28,SIC,29349,13766,15583,20266,9083,ITG,ITG1,19,Sicilia
2021-05-07,EMR,35106,16862,18244,23303,11803,ITH,ITH5,8,Emilia-Romagna
2021-05-01,MAR,9318,3924,5394,3576,5742,ITI,ITI3,11,Marche
2021-03-10,PAB,1262,524,738,1119,143,ITH,ITH1,4,Provincia Autonoma Bolzano / Bozen
2021-01-16,VEN,4611,1542,3069,4611,0,ITH,ITH3,5,Veneto
2021-03-14,VEN,15166,5935,9231,14272,894,ITH,ITH3,5,Veneto
2021-05-06,PAB,5181,2747,2434,2612,2569,ITH,ITH1,4,Provincia Autonoma Bolzano / Bozen
2021-03-05,MAR,6171,2856,3315,4703,1468,ITI,ITI3,11,Marche
2021-05-22,PAT,3239,1589,1650,919,2320,ITH,ITH2,4,Provincia Autonoma Trento
2021-01-21,LIG,1103,385,718,672,431,ITC,ITC3,7,Liguria
2021-03-02,SAR,2865,1459,1406,1712,1153,ITG,ITG2,20,Sardegna
2021-01-07,MAR,1807,636,1171,1807,0,ITI,ITI3,11,Marche
2021-01-06,FVG,710,264,446,710,0,ITH,ITH4,6,Friuli-Venezia Giulia
2021-04-28,SAR,9015,4273,4742,5316,3699,ITG,ITG2,20,Sardegna
2021-04-02,PIE,20130,8298,11832,11703,8427,ITC,ITC1,1,Piemonte
2021-02-12,ABR,1228,567,661,1039,189,ITF,ITF1,13,Abruzzo
2021-05-29,PIE,32654,15166,17488,20512,12142,ITC,ITC1,1,Piemonte
2021-02-23,SIC,8909,4670,4239,8446,463,ITG,ITG1,19,Sicilia
2021-03-09,SIC,13145,5586,7559,10772,2373,ITG,ITG1,19,Sicilia
2021-05-10,VEN,36370,17007,19363,26527,9843,ITH,ITH3,5,Veneto
2021-01-11,SIC,5917,2597,3320,5917,0,ITG,ITG1,19,Sicilia
2021-04-10,ABR,8774,4057,4717,6266,2508,ITF,ITF1,13,Abruzzo
2021-05-29,PAT,2219,1156,1063,815,1404,ITH,ITH2,4,Provincia Autonoma Trento
2021-04-02,PAT,2801,1146,1655,2126,675,ITH,ITH2,4,Provincia Autonoma Trento
2021-04-29,PAB,2630,1351,1279,1936,694,ITH,ITH1,4,Provincia Autonoma Bolzano / Bozen
2021-03-07,VEN,4475,1756,2719,3914,561,ITH,ITH3,5,Veneto
2021-01-14,LIG,2980,1055,1925,2980,0,ITC,ITC3,7,Liguria
2021-05-03,VEN,40606,19774,20832,34180,6426,ITH,ITH3,5,Veneto
2021-04-21,SAR,12074,5557,6517,6541,5533,ITG,ITG2,20,Sardegna
2021-04-24,MAR,12023,5303,6720,7559,4464,ITI,ITI3,11,Marche
2020-12-30,FVG,626,244,382,626,0,ITH,ITH4,6,Friuli-Venezia Giulia
2021-03-12,LIG,6150,2814,3336,3681,2469,ITC,ITC3,7,Liguria
2021-02-25,FVG,3160,1651,1509,3135,25,ITH,ITH4,6,Friuli-Venezia Giulia
2021-02-26,MAR,3630,1499,2131,3154,476,ITI,ITI3,11,Marche
2021-03-09,SAR,5153,2373,2780,4424,729,ITG,ITG2,20,Sardegna
2021-05-05,SAR,10148,4641,5507,8138,2010,ITG,ITG2,20,Sardegna
2021-01-28,LIG,2847,971,1876,39,2808,ITC,ITC3,7,Liguria
2021-01-18,SIC,1650,670,980,1495,155,ITG,ITG1,19,Sicilia
2021-01-23,VEN,4050,1246,2804,31,4019,ITH,ITH3,5,Veneto
2021-01-26,PAB,810,291,519,1,809,ITH,ITH1,4,Provincia Autonoma Bolzano / Bozen
2021-03-21,VEN,11984,4754,7230,8522,3462,ITH,ITH3,5,Veneto
2020-12-30,PIE,730,322,408,730,0,ITC,ITC1,1,Piemonte
2021-03-24,PAB,2041,978,1063,2028,13,ITH,ITH1,4,Provincia Autonoma Bolzano / Bozen
2021-02-25,PIE,12218,5252,6966,11671,547,ITC,ITC1,1,Piemonte
2021-01-21,MAR,899,255,644,585,314,ITI,ITI3,11,Marche
2021-04-09,PAT,2707,1144,1563,1508,1199,ITH,ITH2,4,Provincia Autonoma Trento
2021-02-18,FVG,3218,1492,1726,2811,407,ITH,ITH4,6,Friuli-Venezia Giulia
2021-02-11,PAT,1132,365,767,796,336,ITH,ITH2,4,Provincia Autonoma Trento
2021-02-25,PAT,1641,643,998,1200,441,ITH,ITH2,4,Provincia Autonoma Trento
2021-04-02,FVG,6566,2915,3651,4733,1833,ITH,ITH4,6,Friuli-Venezia Giulia
2020-12-30,PAT,7,3,4,7,0,ITH,ITH2,4,Provincia Autonoma Trento
2021-04-16,FVG,6913,2997,3916,4989,1924,ITH,ITH4,6,Friuli-Venezia Giulia
2021-01-18,SAR,904,326,578,780,124,ITG,ITG2,20,Sardegna
2021-05-23,ABR,9886,4701,5185,7190,2696,ITF,ITF1,13,Abruzzo
2021-02-18,PIE,4790,2093,2697,4360,430,ITC,ITC1,1,Piemonte
2021-03-16,SAR,4374,1949,2425,3452,922,ITG,ITG2,20,Sardegna
2021-03-17,PAB,581,213,368,580,1,ITH,ITH1,4,Provincia Autonoma Bolzano / Bozen
2021-05-13,PAB,2989,1352,1637,1059,1930,ITH,ITH1,4,Provincia Autonoma Bolzano / Bozen
2021-04-16,PIE,28388,13206,15182,23404,4984,ITC,ITC1,1,Piemonte
2021-01-30,VEN,8747,2672,6075,693,8054,ITH,ITH3,5,Veneto
2021-02-11,FVG,1930,664,1266,1738,192,ITH,ITH4,6,Friuli-Venezia Giulia
2021-03-12,MAR,4640,1972,2668,3402,1238,ITI,ITI3,11,Marche
2021-04-09,FVG,7763,3528,4235,6519,1244,ITH,ITH4,6,Friuli-Venezia Giulia
2021-01-14,MAR,2010,692,1318,2010,0,ITI,ITI3,11,Marche
2021-04-16,PAT,2837,1344,1493,2692,145,ITH,ITH2,4,Provincia Autonoma Trento
2021-02-18,PAT,1205,426,779,1143,62,ITH,ITH2,4,Provincia Autonoma Trento
2021-01-19,PAB,853,371,482,723,130,ITH,ITH1,4,Provincia Autonoma Bolzano / Bozen
2021-01-11,SAR,1183,505,678,1183,0,ITG,ITG2,20,Sardegna
2021-02-09,PAB,317,126,191,1,316,ITH,ITH1,4,Provincia Autonoma Bolzano / Bozen
2021-01-25,SAR,588,212,376,22,566,ITG,ITG2,20,Sardegna
2021-01-06,PAT,42,13,29,42,0,ITH,ITH2,4,Provincia Autonoma Trento
2021-01-13,PIE,10080,3223,6857,10080,0,ITC,ITC1,1,Piemonte
2021-05-03,MOL,2484,1164,1320,2321,163,ITF,ITF2,14,Molise
2021-02-10,EMR,4019,1383,2636,2764,1255,ITH,ITH5,8,Emilia-Romagna
2021-01-07,ABR,1603,552,1051,1603,0,ITF,ITF1,13,Abruzzo
2021-04-08,EMR,30825,14130,16695,25525,5300,ITH,ITH5,8,Emilia-Romagna
2021-02-02,PAB,1745,506,1239,8,1737,ITH,ITH1,4,Provincia Autonoma Bolzano / Bozen
2021-01-06,PIE,3116,1111,2005,3116,0,ITC,ITC1,1,Piemonte
2021-05-06,VDA,1063,509,554,679,384,ITC,ITC2,2,Valle d'Aosta / Vallée d'Aoste
2021-02-17,EMR,6537,2763,3774,5765,772,ITH,ITH5,8,Emilia-Romagna
2021-03-27,LAZ,26018,10401,15617,19548,6470,ITI,ITI4,12,Lazio
2021-03-31,VDA,555,302,253,529,26,ITC,ITC2,2,Valle d'Aosta / Vallée d'Aoste
2021-04-17,ABR,7346,3398,3948,4293,3053,ITF,ITF1,13,Abruzzo
2021-05-23,LAZ,47023,22783,24240,39683,7340,ITI,ITI4,12,Lazio
2021-02-19,ABR,3300,1551,1749,3200,100,ITF,ITF1,13,Abruzzo
2021-05-27,VDA,1089,497,592,586,503,ITC,ITC2,2,Valle d'Aosta / Vallée d'Aoste
2021-05-13,VDA,1139,556,583,540,599,ITC,ITC2,2,Valle d'Aosta / Vallée d'Aoste
2021-02-02,VDA,272,70,202,2,270,ITC,ITC2,2,Valle d'Aosta / Vallée d'Aoste
2021-05-09,LAZ,37524,17249,20275,26258,11266,ITI,ITI4,12,Lazio
2021-05-10,MOL,2889,1285,1604,2516,373,ITF,ITF2,14,Molise
2021-03-25,EMR,21391,9347,12044,14403,6988,ITH,ITH5,8,Emilia-Romagna
2021-04-23,UMB,6607,2786,3821,3488,3119,ITI,ITI2,10,Umbria
2021-04-17,MOL,3051,1500,1551,1565,1486,ITF,ITF2,14,Molise
2021-04-11,FVG,3433,1520,1913,2527,906,ITH,ITH4,6,Friuli-Venezia Giulia
2021-01-25,EMR,6456,2145,4311,207,6249,ITH,ITH5,8,Emilia-Romagna
2021-04-27,VDA,978,423,555,686,292,ITC,ITC2,2,Valle d'Aosta / Vallée d'Aoste
2021-03-19,TOS,10136,4457,5679,7271,2865,ITI,ITI1,9,Toscana
2021-01-24,PAB,12,10,2,0,12,ITH,ITH1,4,Provincia Autonoma Bolzano / Bozen
2020-12-28,PIE,1,1,0,1,0,ITC,ITC1,1,Piemonte
2021-01-09,LOM,12411,4573,7838,12411,0,ITC,ITC4,3,Lombardia
2021-01-21,TOS,1589,686,903,867,722,ITI,ITI1,9,Toscana
2021-03-08,VDA,482,231,251,237,245,ITC,ITC2,2,Valle d'Aosta / Vallée d'Aoste
2021-05-12,EMR,38159,17945,20214,28556,9603,ITH,ITH5,8,Emilia-Romagna
2021-03-11,UMB,3565,1697,1868,2559,1006,ITI,ITI2,10,Umbria
2021-05-01,MOL,2641,1266,1375,420,2221,ITF,ITF2,14,Molise
2021-03-05,MOL,1219,649,570,1015,204,ITF,ITF2,14,Molise
2021-05-31,PAT,4327,2010,2317,1506,2821,ITH,ITH2,4,Provincia Autonoma Trento
2021-01-30,CAM,10721,5079,5642,38,10683,ITF,ITF3,15,Campania
2021-03-25,BAS,1879,601,1278,1533,346,ITF,ITF5,17,Basilicata
2021-03-14,LIG,1659,752,907,1055,604,ITC,ITC3,7,Liguria
2021-05-21,BAS,4574,2319,2255,1493,3081,ITF,ITF5,17,Basilicata
2021-05-05,VEN,43963,21083,22880,37437,6526,ITH,ITH3,5,Veneto
2021-01-23,CAL,400,186,214,358,42,ITF,ITF6,18,Calabria
2021-04-30,LAZ,41234,18256,22978,27062,14172,ITI,ITI4,12,Lazio
2021-03-16,EMR,12241,5026,7215,4933,7308,ITH,ITH5,8,Emilia-Romagna
2021-05-11,VDA,645,325,320,494,151,ITC,ITC2,2,Valle d'Aosta / Vallée d'Aoste
2021-01-06,UMB,846,325,521,846,0,ITI,ITI2,10,Umbria
2021-04-26,MAR,8980,3983,4997,5958,3022,ITI,ITI3,11,Marche
2021-03-28,CAL,2591,1198,1393,1505,1086,ITF,ITF6,18,Calabria
2021-02-26,MOL,563,260,303,490,73,ITF,ITF2,14,Molise
2021-04-30,SIC,35225,16460,18765,24020,11205,ITG,ITG1,19,Sicilia
2021-01-20,UMB,613,222,391,613,0,ITI,ITI2,10,Umbria
2021-02-03,BAS,666,300,366,32,634,ITF,ITF5,17,Basilicata
2021-01-23,LIG,809,295,514,153,656,ITC,ITC3,7,Liguria
2021-01-30,CAL,2180,1149,1031,358,1822,ITF,ITF6,18,Calabria
2021-03-04,SIC,15181,6544,8637,10983,4198,ITG,ITG1,19,Sicilia
2021-01-23,CAM,3838,2028,1810,273,3565,ITF,ITF3,15,Campania
2021-03-16,VEN,12516,5347,7169,6902,5614,ITH,ITH3,5,Veneto
2021-05-17,LIG,11828,5358,6470,8526,3302,ITC,ITC3,7,Liguria
2021-05-07,LAZ,48145,22568,25577,30428,17717,ITI,ITI4,12,Lazio
2021-03-09,EMR,14704,5984,8720,10748,3956,ITH,ITH5,8,Emilia-Romagna
2021-02-03,ABR,2062,718,1344,419,1643,ITF,ITF1,13,Abruzzo
2021-02-17,CAL,1832,797,1035,1621,211,ITF,ITF6,18,Calabria
2021-03-19,MOL,1184,482,702,757,427,ITF,ITF2,14,Molise
2021-04-02,PUG,12593,5767,6826,8073,4520,ITF,ITF4,16,Puglia
2021-04-08,CAM,28269,13639,14630,22433,5836,ITF,ITF3,15,Campania
2021-06-01,BAS,6133,2922,3211,3059,3074,ITF,ITF5,17,Basilicata
2021-05-07,SIC,36652,17312,19340,25024,11628,ITG,ITG1,19,Sicilia
2021-02-28,ABR,1706,510,1196,1704,2,ITF,ITF1,13,Abruzzo
2021-05-23,EMR,25396,11819,13577,13851,11545,ITH,ITH5,8,Emilia-Romagna
2021-01-30,LIG,1660,566,1094,24,1636,ITC,ITC3,7,Liguria
2021-03-23,VEN,22148,10186,11962,17429,4719,ITH,ITH3,5,Veneto
2021-05-15,PAB,6996,3684,3312,6701,295,ITH,ITH1,4,Provincia Autonoma Bolzano / Bozen
2021-05-19,VEN,32380,14852,17528,16645,15735,ITH,ITH3,5,Veneto
2021-01-13,SIC,5269,2494,2775,5269,0,ITG,ITG1,19,Sicilia
2021-03-28,LIG,1141,511,630,390,751,ITC,ITC3,7,Liguria
2021-04-18,PAT,1855,845,1010,1846,9,ITH,ITH2,4,Provincia Autonoma Trento
2021-03-18,LAZ,14225,6077,8148,7835,6390,ITI,ITI4,12,Lazio
2021-04-01,CAM,24338,11687,12651,20205,4133,ITF,ITF3,15,Campania
2021-04-08,CAL,9391,4426,4965,5804,3587,ITF,ITF6,18,Calabria
2021-05-10,MAR,9447,4336,5111,4895,4552,ITI,ITI3,11,Marche
2021-04-12,BAS,2170,1051,1119,1679,491,ITF,ITF5,17,Basilicata
2021-01-14,MOL,646,239,407,646,0,ITF,ITF2,14,Molise
2021-03-14,MAR,2500,1032,1468,1907,593,ITI,ITI3,11,Marche
2021-01-08,FVG,2322,747,1575,2322,0,ITH,ITH4,6,Friuli-Venezia Giulia
2021-03-18,SIC,15602,7783,7819,9864,5738,ITG,ITG1,19,Sicilia
2021-02-01,VEN,8557,2500,6057,161,8396,ITH,ITH3,5,Veneto
2021-05-14,SAR,13889,6375,7514,10705,3184,ITG,ITG2,20,Sardegna
2021-04-18,PIE,22951,10817,12134,20197,2754,ITC,ITC1,1,Piemonte
2021-05-22,PAB,6821,3552,3269,4654,2167,ITH,ITH1,4,Provincia Autonoma Bolzano / Bozen
2021-01-27,LOM,8034,2672,5362,809,7225,ITC,ITC4,3,Lombardia
2021-05-21,LOM,93490,45098,48392,29048,64442,ITC,ITC4,3,Lombardia
2021-01-23,MAR,557,190,367,123,434,ITI,ITI3,11,Marche
2021-02-27,FVG,3528,1200,2328,3527,1,ITH,ITH4,6,Friuli-Venezia Giulia
2021-06-02,TOS,27145,13390,13755,21659,5486,ITI,ITI1,9,Toscana
2021-04-25,FVG,2363,990,1373,2352,11,ITH,ITH4,6,Friuli-Venezia Giulia
2021-04-01,CAL,8493,3843,4650,3979,4514,ITF,ITF6,18,Calabria
2021-02-08,TOS,4097,1360,2737,3638,459,ITI,ITI1,9,Toscana
2021-05-21,CAM,63378,29336,34042,43178,20200,ITF,ITF3,15,Campania
2021-02-03,LAZ,6488,2488,4000,964,5524,ITI,ITI4,12,Lazio
2021-06-01,ABR,10924,4822,6102,6560,4364,ITF,ITF1,13,Abruzzo
2021-04-13,TOS,8490,3508,4982,6032,2458,ITI,ITI1,9,Toscana
2021-01-27,SAR,1411,496,915,79,1332,ITG,ITG2,20,Sardegna
2021-03-28,MAR,4126,1739,2387,2435,1691,ITI,ITI3,11,Marche
2021-04-16,PUG,35843,16844,18999,32562,3281,ITF,ITF4,16,Puglia
2021-04-02,PAB,2077,837,1240,720,1357,ITH,ITH1,4,Provincia Autonoma Bolzano / Bozen
2021-01-15,PIE,9113,3011,6102,9113,0,ITC,ITC1,1,Piemonte
2021-02-18,PUG,4378,1846,2532,3774,604,ITF,ITF4,16,Puglia
2021-04-06,VEN,28870,13273,15597,23802,5068,ITH,ITH3,5,Veneto
2021-03-06,PAT,783,277,506,632,151,ITH,ITH2,4,Provincia Autonoma Trento
2021-03-18,LOM,27391,10955,16436,16150,11241,ITC,ITC4,3,Lombardia
2021-02-11,PUG,3701,1402,2299,2423,1278,ITF,ITF4,16,Puglia
2021-05-26,TOS,35179,16775,18404,20168,15011,ITI,ITI1,9,Toscana
2021-05-21,CAL,21326,10857,10469,13963,7363,ITF,ITF6,18,Calabria
2021-03-30,TOS,16861,7498,9363,13297,3564,ITI,ITI1,9,Toscana
2021-02-20,FVG,2068,933,1135,1924,144,ITH,ITH4,6,Friuli-Venezia Giulia
2021-04-12,ABR,6225,2949,3276,5051,1174,ITF,ITF1,13,Abruzzo
2021-01-01,PAT,213,50,163,213,0,ITH,ITH2,4,Provincia Autonoma Trento
2021-02-25,UMB,1336,497,839,1284,52,ITI,ITI2,10,Umbria
2021-02-01,EMR,10320,3610,6710,362,9958,ITH,ITH5,8,Emilia-Romagna
2021-01-28,TOS,6282,1882,4400,354,5928,ITI,ITI1,9,Toscana
2021-02-10,BAS,548,238,310,496,52,ITF,ITF5,17,Basilicata
2021-01-12,MAR,1227,413,814,1227,0,ITI,ITI3,11,Marche
2021-01-16,SAR,1492,525,967,1492,0,ITG,ITG2,20,Sardegna
2021-01-16,LOM,15429,5732,9697,15429,0,ITC,ITC4,3,Lombardia
2021-03-23,EMR,18697,8069,10628,12010,6687,ITH,ITH5,8,Emilia-Romagna
2021-04-16,UMB,8109,3746,4363,6272,1837,ITI,ITI2,10,Umbria
2021-04-30,UMB,6232,2962,3270,2843,3389,ITI,ITI2,10,Umbria
2021-01-31,PUG,1813,828,985,74,1739,ITF,ITF4,16,Puglia
2021-05-31,FVG,8246,4036,4210,6344,1902,ITH,ITH4,6,Friuli-Venezia Giulia
2021-03-07,LOM,12082,5355,6727,9523,2559,ITC,ITC4,3,Lombardia
2021-05-04,VDA,1135,510,625,462,673,ITC,ITC2,2,Valle d'Aosta / Vallée d'Aoste
2021-01-13,UMB,450,139,311,450,0,ITI,ITI2,10,Umbria
2021-02-06,CAL,2906,1337,1569,442,2464,ITF,ITF6,18,Calabria
2021-01-27,BAS,411,175,236,113,298,ITF,ITF5,17,Basilicata
2021-05-10,LIG,12505,5504,7001,6132,6373,ITC,ITC3,7,Liguria
2021-01-16,CAM,3369,1675,1694,3369,0,ITF,ITF3,15,Campania
2021-04-23,SIC,28888,13845,15043,22941,5947,ITG,ITG1,19,Sicilia
2021-02-10,ABR,947,312,635,503,444,ITF,ITF1,13,Abruzzo
2021-01-18,EMR,3127,879,2248,2449,678,ITH,ITH5,8,Emilia-Romagna
2021-03-15,VDA,362,123,239,159,203,ITC,ITC2,2,Valle d'Aosta / Vallée d'Aoste
2021-01-17,VDA,131,56,75,131,0,ITC,ITC2,2,Valle d'Aosta / Vallée d'Aoste
2021-03-04,UMB,4485,1853,2632,3657,828,ITI,ITI2,10,Umbria
2021-04-24,MOL,2546,1199,1347,705,1841,ITF,ITF2,14,Molise
2021-05-03,LIG,13266,5918,7348,6454,6812,ITC,ITC3,7,Liguria
2021-04-01,BAS,2802,1126,1676,2083,719,ITF,ITF5,17,Basilicata
2021-05-12,VEN,36329,17574,18755,31252,5077,ITH,ITH3,5,Veneto
2021-03-21,LIG,550,220,330,69,481,ITC,ITC3,7,Liguria
2021-03-21,CAM,9982,4591,5391,7592,2390,ITF,ITF3,15,Campania
2021-03-11,LAZ,23806,10586,13220,17577,6229,ITI,ITI4,12,Lazio
2021-05-05,EMR,29367,13656,15711,18130,11237,ITH,ITH5,8,Emilia-Romagna
2021-05-29,PUG,29407,13869,15538,20340,9067,ITF,ITF4,16,Puglia
2021-02-10,CAM,6904,3413,3491,6728,176,ITF,ITF3,15,Campania
2021-01-21,MOL,6,2,4,6,0,ITF,ITF2,14,Molise
2021-02-20,PAT,407,245,162,123,284,ITH,ITH2,4,Provincia Autonoma Trento
2021-04-15,CAL,7593,3721,3872,5982,1611,ITF,ITF6,18,Calabria
2021-05-03,MAR,10196,4605,5591,4789,5407,ITI,ITI3,11,Marche
2021-03-11,SIC,15447,6518,8929,12882,2565,ITG,ITG1,19,Sicilia
2021-01-02,ABR,548,218,330,548,0,ITF,ITF1,13,Abruzzo
2021-05-19,TOS,27767,13441,14326,18872,8895,ITI,ITI1,9,Toscana
2021-04-26,ABR,8563,4066,4497,7349,1214,ITF,ITF1,13,Abruzzo
2021-01-15,FVG,2021,605,1416,2021,0,ITH,ITH4,6,Friuli-Venezia Giulia
2021-05-07,SAR,14126,6457,7669,9626,4500,ITG,ITG2,20,Sardegna
2021-01-20,LAZ,4806,1942,2864,3263,1543,ITI,ITI4,12,Lazio
2021-01-31,VDA,291,91,200,58,233,ITC,ITC2,2,Valle d'Aosta / Vallée d'Aoste
2021-02-27,PIE,12691,4851,7840,12346,345,ITC,ITC1,1,Piemonte
2021-04-25,PIE,20223,9303,10920,17722,2501,ITC,ITC1,1,Piemonte
2021-05-14,LAZ,50732,23157,27575,32520,18212,ITI,ITI4,12,Lazio
2021-05-07,LOM,92045,43578,48467,69868,22177,ITC,ITC4,3,Lombardia
2021-05-28,CAM,72280,34655,37625,26743,45537,ITF,ITF3,15,Campania
2021-02-10,CAL,2509,1078,1431,884,1625,ITF,ITF6,18,Calabria
2021-04-11,PAT,2340,1135,1205,2249,91,ITH,ITH2,4,Provincia Autonoma Trento
2021-03-12,MOL,1459,637,822,1423,36,ITF,ITF2,14,Molise
2021-05-22,PUG,34069,15606,18463,23842,10227,ITF,ITF4,16,Puglia
2021-04-19,ABR,6225,2856,3369,3854,2371,ITF,ITF1,13,Abruzzo
2021-01-20,SIC,837,427,410,574,263,ITG,ITG1,19,Sicilia
2021-02-21,ABR,1218,550,668,1217,1,ITF,ITF1,13,Abruzzo
2021-01-22,FVG,90,30,60,0,90,ITH,ITH4,6,Friuli-Venezia Giulia
2021-03-26,PAB,1645,722,923,512,1133,ITH,ITH1,4,Provincia Autonoma Bolzano / Bozen
2021-02-06,LIG,1892,768,1124,145,1747,ITC,ITC3,7,Liguria
2021-03-06,FVG,3500,1196,2304,3175,325,ITH,ITH4,6,Friuli-Venezia Giulia
2021-03-18,SAR,7255,3070,4185,5652,1603,ITG,ITG2,20,Sardegna
2021-04-19,BAS,4163,1910,2253,2526,1637,ITF,ITF5,17,Basilicata
2021-03-21,MAR,4505,1873,2632,1629,2876,ITI,ITI3,11,Marche
2021-03-30,VEN,35886,15238,20648,30637,5249,ITH,ITH3,5,Veneto
2021-03-25,LAZ,26916,11511,15405,20312,6604,ITI,ITI4,12,Lazio
2021-03-22,VDA,560,205,355,333,227,ITC,ITC2,2,Valle d'Aosta / Vallée d'Aoste
2021-01-27,LAZ,6114,2387,3727,997,5117,ITI,ITI4,12,Lazio
2021-05-02,PIE,25045,11263,13782,14300,10745,ITC,ITC1,1,Piemonte
2021-05-28,CAL,20881,10127,10754,11469,9412,ITF,ITF6,18,Calabria
2021-03-25,LOM,42628,15905,26723,30038,12590,ITC,ITC4,3,Lombardia
2021-04-06,TOS,22170,9774,12396,18456,3714,ITI,ITI1,9,Toscana
2021-01-27,SIC,7526,3836,3690,182,7344,ITG,ITG1,19,Sicilia
2021-02-04,PAB,1958,593,1365,8,1950,ITH,ITH1,4,Provincia Autonoma Bolzano / Bozen
2021-01-08,PAT,1449,313,1136,1449,0,ITH,ITH2,4,Provincia Autonoma Trento
2021-03-25,SAR,8795,3704,5091,7490,1305,ITG,ITG2,20,Sardegna
2021-01-30,MAR,1905,668,1237,29,1876,ITI,ITI3,11,Marche
2021-05-21,SAR,20560,10037,10523,15065,5495,ITG,ITG2,20,Sardegna
2021-02-08,VEN,4976,1541,3435,1929,3047,ITH,ITH3,5,Veneto
2021-05-29,PAB,7129,3766,3363,3994,3135,ITH,ITH1,4,Provincia Autonoma Bolzano / Bozen
2021-03-13,PIE,13044,4720,8324,11600,1444,ITC,ITC1,1,Piemonte
2021-01-28,MOL,613,217,396,17,596,ITF,ITF2,14,Molise
2021-04-09,PUG,21842,9392,12450,17220,4622,ITF,ITF4,16,Puglia
2021-05-14,LOM,85598,41229,44369,55534,30064,ITC,ITC4,3,Lombardia
2021-04-18,FVG,6038,2799,3239,5631,407,ITH,ITH4,6,Friuli-Venezia Giulia
2021-05-14,CAM,60793,27462,33331,36305,24488,ITF,ITF3,15,Campania
2021-05-11,UMB,6226,2827,3399,4025,2201,ITI,ITI2,10,Umbria
2021-04-09,PAB,2926,1292,1634,2196,730,ITH,ITH1,4,Provincia Autonoma Bolzano / Bozen
2021-02-15,VEN,4386,1821,2565,4146,240,ITH,ITH3,5,Veneto
2021-02-27,PAT,1029,457,572,608,421,ITH,ITH2,4,Provincia Autonoma Trento
2021-02-03,SAR,1119,419,700,426,693,ITG,ITG2,20,Sardegna
2021-01-08,PIE,5531,1761,3770,5531,0,ITC,ITC1,1,Piemonte
2021-02-25,PUG,11959,5055,6904,10793,1166,ITF,ITF4,16,Puglia
2021-02-11,PAB,1093,431,662,239,854,ITH,ITH1,4,Provincia Autonoma Bolzano / Bozen
2021-04-25,PAT,1970,939,1031,1963,7,ITH,ITH2,4,Provincia Autonoma Trento
2021-04-11,CAM,17522,8605,8917,15440,2082,ITF,ITF3,15,Campania
2021-02-18,LAZ,10017,4976,5041,9208,809,ITI,ITI4,12,Lazio
2021-02-13,FVG,566,179,387,560,6,ITH,ITH4,6,Friuli-Venezia Giulia
2021-05-26,EMR,32837,14528,18309,10158,22679,ITH,ITH5,8,Emilia-Romagna
2021-02-05,ABR,1534,521,1013,788,746,ITF,ITF1,13,Abruzzo
2021-02-19,MOL,169,93,76,167,2,ITF,ITF2,14,Molise
2021-02-02,LIG,2668,1005,1663,134,2534,ITC,ITC3,7,Liguria
2021-05-18,ABR,12116,5662,6454,7733,4383,ITF,ITF1,13,Abruzzo
2021-03-22,PAB,1133,514,619,1129,4,ITH,ITH1,4,Provincia Autonoma Bolzano / Bozen
2021-03-26,VEN,29539,13117,16422,24072,5467,ITH,ITH3,5,Veneto
2021-02-13,EMR,3627,1085,2542,3029,598,ITH,ITH5,8,Emilia-Romagna
2021-03-09,UMB,4051,1971,2080,2760,1291,ITI,ITI2,10,Umbria
2021-01-04,SAR,592,217,375,592,0,ITG,ITG2,20,Sardegna
2021-03-10,PUG,14412,6250,8162,11294,3118,ITF,ITF4,16,Puglia
2021-03-17,MAR,3428,1494,1934,107,3321,ITI,ITI3,11,Marche
2021-05-15,LIG,7184,3195,3989,4297,2887,ITC,ITC3,7,Liguria
2021-02-23,LOM,11793,4797,6996,11466,327,ITC,ITC4,3,Lombardia
2021-04-23,LAZ,37653,18082,19571,22403,15250,ITI,ITI4,12,Lazio
2021-02-06,CAM,5340,2665,2675,2102,3238,ITF,ITF3,15,Campania
2021-04-13,VDA,373,171,202,329,44,ITC,ITC2,2,Valle d'Aosta / Vallée d'Aoste
2021-04-11,CAL,4166,1895,2271,2223,1943,ITF,ITF6,18,Calabria
2021-05-25,PAB,3809,1968,1841,2935,874,ITH,ITH1,4,Provincia Autonoma Bolzano / Bozen
2021-02-18,SIC,5471,3152,2319,5044,427,ITG,ITG1,19,Sicilia
2021-02-22,ABR,2642,1173,1469,2612,30,ITF,ITF1,13,Abruzzo
2021-06-02,UMB,3938,1893,2045,3898,40,ITI,ITI2,10,Umbria
2021-04-28,CAM,36409,17619,18790,26659,9750,ITF,ITF3,15,Campania
2021-02-21,PUG,2175,472,1703,2114,61,ITF,ITF4,16,Puglia
2021-03-09,VEN,16463,7381,9082,10144,6319,ITH,ITH3,5,Veneto
2021-01-16,LIG,1278,557,721,1278,0,ITC,ITC3,7,Liguria
2021-02-01,LAZ,5675,2177,3498,354,5321,ITI,ITI4,12,Lazio
2021-03-02,FVG,4219,1519,2700,2720,1499,ITH,ITH4,6,Friuli-Venezia Giulia
2021-03-21,PAT,129,69,60,129,0,ITH,ITH2,4,Provincia Autonoma Trento
2021-06-03,PUG,22482,10738,11744,14362,8120,ITF,ITF4,16,Puglia
2021-02-22,BAS,1790,773,1017,1737,53,ITF,ITF5,17,Basilicata
2021-05-24,PIE,28616,13130,15486,16978,11638,ITC,ITC1,1,Piemonte
2021-02-20,UMB,282,100,182,258,24,ITI,ITI2,10,Umbria
2021-06-01,MOL,2547,1307,1240,2470,77,ITF,ITF2,14,Molise
2021-04-28,LIG,14442,6519,7923,6458,7984,ITC,ITC3,7,Liguria
2021-04-02,TOS,31944,13534,18410,23921,8023,ITI,ITI1,9,Toscana
2021-05-24,PAT,4377,2009,2368,1344,3033,ITH,ITH2,4,Provincia Autonoma Trento
2021-05-31,SIC,37495,16706,20789,21378,16117,ITG,ITG1,19,Sicilia
2021-03-05,PAB,1839,625,1214,1397,442,ITH,ITH1,4,Provincia Autonoma Bolzano / Bozen
2021-02-28,MAR,2836,1251,1585,2830,6,ITI,ITI3,11,Marche
2021-04-16,SAR,14441,6488,7953,9098,5343,ITG,ITG2,20,Sardegna
2021-01-04,VEN,6736,2033,4703,6736,0,ITH,ITH3,5,Veneto
2021-03-27,VDA,333,164,169,302,31,ITC,ITC2,2,Valle d'Aosta / Vallée d'Aoste
2021-05-08,PAB,4426,2381,2045,3762,664,ITH,ITH1,4,Provincia Autonoma Bolzano / Bozen
2021-01-27,FVG,1272,425,847,450,822,ITH,ITH4,6,Friuli-Venezia Giulia
2021-02-04,PUG,5927,2366,3561,1195,4732,ITF,ITF4,16,Puglia
2021-02-20,VEN,6424,2014,4410,6353,71,ITH,ITH3,5,Veneto
2021-03-04,PAT,2358,793,1565,1580,778,ITH,ITH2,4,Provincia Autonoma Trento
2020-12-30,LIG,12,5,7,12,0,ITC,ITC3,7,Liguria
2021-05-01,BAS,4703,2135,2568,3952,751,ITF,ITF5,17,Basilicata
2021-05-09,FVG,7348,3297,4051,3493,3855,ITH,ITH4,6,Friuli-Venezia Giulia
2021-05-07,PIE,32943,15548,17395,18900,14043,ITC,ITC1,1,Piemonte
2021-05-19,LOM,82642,39501,43141,33781,48861,ITC,ITC4,3,Lombardia
2021-01-03,CAL,6,3,3,6,0,ITF,ITF6,18,Calabria
2021-05-15,MOL,2979,1398,1581,2595,384,ITF,ITF2,14,Molise
2021-02-06,LOM,15239,5532,9707,1017,14222,ITC,ITC4,3,Lombardia
2021-04-06,LAZ,23879,10653,13226,16776,7103,ITI,ITI4,12,Lazio
2021-03-16,TOS,4903,1884,3019,2653,2250,ITI,ITI1,9,Toscana
2021-03-30,SAR,8642,3462,5180,6368,2274,ITG,ITG2,20,Sardegna
2021-03-08,CAL,5412,2900,2512,4350,1062,ITF,ITF6,18,Calabria
2021-03-04,PIE,14496,5734,8762,11548,2948,ITC,ITC1,1,Piemonte
2021-02-26,BAS,2149,904,1245,2069,80,ITF,ITF5,17,Basilicata
2021-05-14,SIC,52242,24467,27775,36396,15846,ITG,ITG1,19,Sicilia
2021-05-07,PAT,5986,3079,2907,5148,838,ITH,ITH2,4,Provincia Autonoma Trento
2021-02-03,UMB,725,174,551,67,658,ITI,ITI2,10,Umbria
2021-03-10,VDA,438,183,255,225,213,ITC,ITC2,2,Valle d'Aosta / Vallée d'Aoste
2021-02-16,PAB,530,205,325,530,0,ITH,ITH1,4,Provincia Autonoma Bolzano / Bozen
2021-02-02,MOL,539,176,363,216,323,ITF,ITF2,14,Molise
2021-01-03,CAM,3837,2009,1828,3837,0,ITF,ITF3,15,Campania
2021-02-01,SIC,6069,2682,3387,296,5773,ITG,ITG1,19,Sicilia
2021-04-28,MOL,1683,913,770,466,1217,ITF,ITF2,14,Molise
2021-05-18,BAS,5897,2856,3041,3403,2494,ITF,ITF5,17,Basilicata
2021-05-09,EMR,25489,12190,13299,18525,6964,ITH,ITH5,8,Emilia-Romagna
2021-01-15,LAZ,6574,2705,3869,6574,0,ITI,ITI4,12,Lazio
2021-04-20,PIE,25453,11655,13798,19109,6344,ITC,ITC1,1,Piemonte
2021-03-25,CAM,19990,9335,10655,16487,3503,ITF,ITF3,15,Campania
2021-01-19,ABR,111,55,56,91,20,ITF,ITF1,13,Abruzzo
2021-01-27,EMR,8362,2947,5415,463,7899,ITH,ITH5,8,Emilia-Romagna
2021-01-20,CAL,1399,626,773,1398,1,ITF,ITF6,18,Calabria
2021-05-17,PUG,32200,14751,17449,20566,11634,ITF,ITF4,16,Puglia
2021-04-11,LIG,4248,1930,2318,3999,249,ITC,ITC3,7,Liguria
2021-06-02,VEN,20284,10229,10055,15947,4337,ITH,ITH3,5,Veneto
2021-05-16,UMB,5318,2535,2783,5266,52,ITI,ITI2,10,Umbria
2021-05-26,FVG,12706,6299,6407,9428,3278,ITH,ITH4,6,Friuli-Venezia Giulia
2021-05-01,ABR,10745,5052,5693,5771,4974,ITF,ITF1,13,Abruzzo
2021-05-24,MAR,10794,5110,5684,8120,2674,ITI,ITI3,11,Marche
2021-02-27,TOS,1983,756,1227,1081,902,ITI,ITI1,9,Toscana
2021-03-13,SAR,2755,1076,1679,2474,281,ITG,ITG2,20,Sardegna
2021-04-27,SIC,26395,12717,13678,15589,10806,ITG,ITG1,19,Sicilia
2021-01-20,CAM,1257,650,607,1257,0,ITF,ITF3,15,Campania
2021-02-15,PIE,4432,1597,2835,3227,1205,ITC,ITC1,1,Piemonte
2021-03-20,LAZ,18224,6810,11414,12340,5884,ITI,ITI4,12,Lazio
2021-04-20,PAT,2876,1375,1501,2839,37,ITH,ITH2,4,Provincia Autonoma Trento
2021-05-02,LOM,83497,38330,45167,61037,22460,ITC,ITC4,3,Lombardia
2021-01-26,MAR,2016,746,1270,92,1924,ITI,ITI3,11,Marche
2021-04-14,LOM,47118,21006,26112,34153,12965,ITC,ITC4,3,Lombardia
2021-01-02,LIG,691,245,446,691,0,ITC,ITC3,7,Liguria
2021-04-21,PAT,2893,1349,1544,2843,50,ITH,ITH2,4,Provincia Autonoma Trento
2021-02-28,TOS,1649,667,982,922,727,ITI,ITI1,9,Toscana
2021-02-23,VEN,7375,3250,4125,7105,270,ITH,ITH3,5,Veneto
2021-05-16,VDA,688,341,347,347,341,ITC,ITC2,2,Valle d'Aosta / Vallée d'Aoste
2021-03-14,SAR,607,376,231,607,0,ITG,ITG2,20,Sardegna
2021-01-16,SIC,2782,1198,1584,2782,0,ITG,ITG1,19,Sicilia
2021-01-22,BAS,67,24,43,67,0,ITF,ITF5,17,Basilicata
2021-04-09,SIC,20539,10004,10535,11389,9150,ITG,ITG1,19,Sicilia
2021-02-16,PAT,663,244,419,658,5,ITH,ITH2,4,Provincia Autonoma Trento
2021-02-14,MAR,738,301,437,738,0,ITI,ITI3,11,Marche
2021-05-10,PAT,3205,1644,1561,2701,504,ITH,ITH2,4,Provincia Autonoma Trento
2021-01-05,ABR,1615,604,1011,1615,0,ITF,ITF1,13,Abruzzo
2021-04-21,PIE,25728,11825,13903,20395,5333,ITC,ITC1,1,Piemonte
2021-05-17,SAR,12114,5688,6426,9224,2890,ITG,ITG2,20,Sardegna
2021-02-04,VEN,7388,2024,5364,553,6835,ITH,ITH3,5,Veneto
2021-04-29,MOL,2237,1144,1093,890,1347,ITF,ITF2,14,Molise
2021-01-19,PUG,1221,452,769,1211,10,ITF,ITF4,16,Puglia
2021-03-09,CAL,6308,3247,3061,5329,979,ITF,ITF6,18,Calabria
2021-04-11,SIC,15336,7575,7761,8307,7029,ITG,ITG1,19,Sicilia
2021-05-26,LAZ,46072,20588,25484,34927,11145,ITI,ITI4,12,Lazio
2021-01-30,FVG,2275,745,1530,270,2005,ITH,ITH4,6,Friuli-Venezia Giulia
2021-01-04,LOM,6095,2101,3994,6095,0,ITC,ITC4,3,Lombardia
2021-04-24,PAB,5104,2449,2655,4619,485,ITH,ITH1,4,Provincia Autonoma Bolzano / Bozen
2021-02-05,VDA,294,102,192,101,193,ITC,ITC2,2,Valle d'Aosta / Vallée d'Aoste
2021-04-19,MAR,9601,4497,5104,8020,1581,ITI,ITI3,11,Marche
2021-02-25,SAR,2899,1255,1644,2294,605,ITG,ITG2,20,Sardegna
2021-01-04,CAM,5825,2962,2863,5825,0,ITF,ITF3,15,Campania
2021-01-30,EMR,10077,3519,6558,141,9936,ITH,ITH5,8,Emilia-Romagna
2021-03-24,MOL,1631,658,973,1229,402,ITF,ITF2,14,Molise
2021-04-05,PAB,301,144,157,23,278,ITH,ITH1,4,Provincia Autonoma Bolzano / Bozen
2020-12-30,SIC,176,102,74,176,0,ITG,ITG1,19,Sicilia
2021-01-11,PAT,730,221,509,730,0,ITH,ITH2,4,Provincia Autonoma Trento
2021-01-03,ABR,471,185,286,471,0,ITF,ITF1,13,Abruzzo
2021-03-09,CAM,13881,6637,7244,10096,3785,ITF,ITF3,15,Campania
2021-05-02,BAS,4179,2000,2179,3551,628,ITF,ITF5,17,Basilicata
2021-04-28,VEN,32372,15158,17214,23352,9020,ITH,ITH3,5,Veneto
2021-04-21,FVG,7746,3453,4293,4066,3680,ITH,ITH4,6,Friuli-Venezia Giulia
2021-01-30,PAT,386,132,254,152,234,ITH,ITH2,4,Provincia Autonoma Trento
2021-03-23,LAZ,23503,10229,13274,16926,6577,ITI,ITI4,12,Lazio
2021-01-11,FVG,1882,608,1274,1882,0,ITH,ITH4,6,Friuli-Venezia Giulia
2021-03-07,LIG,1858,1085,773,1557,301,ITC,ITC3,7,Liguria
2021-01-01,UMB,274,105,169,274,0,ITI,ITI2,10,Umbria
2021-04-30,SAR,11128,5297,5831,6919,4209,ITG,ITG2,20,Sardegna
2021-04-11,UMB,3102,1503,1599,3053,49,ITI,ITI2,10,Umbria
2021-01-18,VEN,2762,776,1986,2563,199,ITH,ITH3,5,Veneto
2021-04-04,EMR,9885,4718,5167,7616,2269,ITH,ITH5,8,Emilia-Romagna
2021-04-04,PIE,9254,4059,5195,6541,2713,ITC,ITC1,1,Piemonte
2021-01-19,MOL,173,63,110,162,11,ITF,ITF2,14,Molise
2021-04-15,ABR,7818,3678,4140,5978,1840,ITF,ITF1,13,Abruzzo
2021-02-06,SAR,1970,697,1273,569,1401,ITG,ITG2,20,Sardegna
2021-01-11,PIE,8744,2980,5764,8744,0,ITC,ITC1,1,Piemonte
2021-05-24,TOS,33367,16400,16967,24090,9277,ITI,ITI1,9,Toscana
2021-02-15,LAZ,8025,3540,4485,7394,631,ITI,ITI4,12,Lazio
2021-01-09,MAR,1709,605,1104,1709,0,ITI,ITI3,11,Marche
2021-04-30,VEN,49924,23442,26482,34274,15650,ITH,ITH3,5,Veneto
2021-04-06,PIE,20240,8810,11430,15044,5196,ITC,ITC1,1,Piemonte
2021-01-14,PAB,1946,575,1371,1946,0,ITH,ITH1,4,Provincia Autonoma Bolzano / Bozen
2021-04-27,CAL,9945,4889,5056,8004,1941,ITF,ITF6,18,Calabria
2021-02-22,CAM,10680,3294,7386,10417,263,ITF,ITF3,15,Campania
2021-05-28,LAZ,55835,25545,30290,43361,12474,ITI,ITI4,12,Lazio
2021-03-19,PAB,1906,773,1133,799,1107,ITH,ITH1,4,Provincia Autonoma Bolzano / Bozen
2021-03-06,SIC,12914,5165,7749,10011,2903,ITG,ITG1,19,Sicilia
2021-03-01,FVG,2957,1041,1916,2905,52,ITH,ITH4,6,Friuli-Venezia Giulia
2021-03-20,EMR,16086,6831,9255,9122,6964,ITH,ITH5,8,Emilia-Romagna
2020-12-27,EMR,970,372,598,970,0,ITH,ITH5,8,Emilia-Romagna
2021-04-14,PUG,31796,15014,16782,28490,3306,ITF,ITF4,16,Puglia
2021-03-30,LOM,39483,15485,23998,24700,14783,ITC,ITC4,3,Lombardia
2021-04-21,MAR,10781,4967,5814,9587,1194,ITI,ITI3,11,Marche
2021-01-20,SAR,210,77,133,208,2,ITG,ITG2,20,Sardegna
2021-05-18,VDA,969,484,485,353,616,ITC,ITC2,2,Valle d'Aosta / Vallée d'Aoste
2021-06-03,ABR,7306,3568,3738,4879,2427,ITF,ITF1,13,Abruzzo
2021-02-13,TOS,7785,2360,5425,7558,227,ITI,ITI1,9,Toscana
2021-03-09,LIG,5930,2753,3177,4500,1430,ITC,ITC3,7,Liguria
2021-03-26,MOL,2575,1045,1530,1933,642,ITF,ITF2,14,Molise
2020-12-27,FVG,262,149,113,262,0,ITH,ITH4,6,Friuli-Venezia Giulia
2021-03-21,PAB,768,285,483,14,754,ITH,ITH1,4,Provincia Autonoma Bolzano / Bozen
2021-05-30,UMB,5971,2992,2979,5780,191,ITI,ITI2,10,Umbria
2021-05-02,SAR,5884,2669,3215,5303,581,ITG,ITG2,20,Sardegna
2021-04-18,TOS,8338,4083,4255,7342,996,ITI,ITI1,9,Toscana
2021-01-20,VEN,1038,368,670,386,652,ITH,ITH3,5,Veneto
2020-12-27,PIE,913,369,544,913,0,ITC,ITC1,1,Piemonte
2021-03-16,MAR,3471,1485,1986,290,3181,ITI,ITI3,11,Marche
2021-06-02,LIG,8528,4342,4186,5361,3167,ITC,ITC3,7,Liguria
2021-01-04,PUG,4507,2016,2491,4507,0,ITF,ITF4,16,Puglia
2021-04-12,VDA,486,186,300,323,163,ITC,ITC2,2,Valle d'Aosta / Vallée d'Aoste
2021-06-02,CAM,42756,20114,22642,38113,4643,ITF,ITF3,15,Campania
2021-02-17,LAZ,9181,4603,4578,8307,874,ITI,ITI4,12,Lazio
2021-04-17,BAS,3461,1655,1806,2199,1262,ITF,ITF5,17,Basilicata
2021-04-06,PAT,2258,949,1309,1493,765,ITH,ITH2,4,Provincia Autonoma Trento
2021-06-02,LOM,67995,35048,32947,62634,5361,ITC,ITC4,3,Lombardia
2021-03-27,UMB,4253,1512,2741,3913,340,ITI,ITI2,10,Umbria
2021-04-06,EMR,24621,11114,13507,19884,4737,ITH,ITH5,8,Emilia-Romagna
2021-03-09,PUG,13292,5791,7501,11284,2008,ITF,ITF4,16,Puglia
2021-03-25,VEN,25838,10951,14887,19718,6120,ITH,ITH3,5,Veneto
2021-03-06,EMR,20636,5884,14752,17906,2730,ITH,ITH5,8,Emilia-Romagna
2021-03-08,LOM,29712,11174,18538,22643,7069,ITC,ITC4,3,Lombardia
2021-03-29,CAL,5686,2404,3282,3930,1756,ITF,ITF6,18,Calabria
2021-03-04,MAR,6486,2868,3618,5093,1393,ITI,ITI3,11,Marche
2021-05-02,LIG,3876,1767,2109,505,3371,ITC,ITC3,7,Liguria
2021-03-20,TOS,6490,2884,3606,5354,1136,ITI,ITI1,9,Toscana
2021-01-24,CAM,4128,2123,2005,383,3745,ITF,ITF3,15,Campania
2021-04-26,VDA,715,327,388,545,170,ITC,ITC2,2,Valle d'Aosta / Vallée d'Aoste
2021-05-12,PAB,3790,2058,1732,3637,153,ITH,ITH1,4,Provincia Autonoma Bolzano / Bozen
2021-02-24,PIE,11409,4629,6780,10904,505,ITC,ITC1,1,Piemonte
2021-03-23,PUG,10414,5002,5412,3944,6470,ITF,ITF4,16,Puglia
2021-02-26,FVG,3735,2093,1642,3587,148,ITH,ITH4,6,Friuli-Venezia Giulia
2021-02-18,ABR,2288,933,1355,2158,130,ITF,ITF1,13,Abruzzo
2021-05-13,EMR,35506,16348,19158,27741,7765,ITH,ITH5,8,Emilia-Romagna
2021-01-09,VDA,443,199,244,443,0,ITC,ITC2,2,Valle d'Aosta / Vallée d'Aoste
2021-03-03,LAZ,17396,7438,9958,13102,4294,ITI,ITI4,12,Lazio
2021-01-20,LIG,1550,555,995,1538,12,ITC,ITC3,7,Liguria
2021-03-13,VEN,17180,7259,9921,14047,3133,ITH,ITH3,5,Veneto
2021-02-24,UMB,1520,565,955,1505,15,ITI,ITI2,10,Umbria
2021-03-09,PAB,1194,543,651,1192,2,ITH,ITH1,4,Provincia Autonoma Bolzano / Bozen
2021-01-17,SAR,860,277,583,859,1,ITG,ITG2,20,Sardegna
2021-05-31,ABR,11219,5044,6175,6908,4311,ITF,ITF1,13,Abruzzo
2021-05-06,LAZ,48629,22616,26013,31105,17524,ITI,ITI4,12,Lazio
2021-01-24,LOM,1199,457,742,536,663,ITC,ITC4,3,Lombardia
2021-03-13,MAR,5766,2656,3110,1809,3957,ITI,ITI3,11,Marche
2021-04-29,SAR,11112,5108,6004,6759,4353,ITG,ITG2,20,Sardegna
2021-03-08,CAM,14542,6717,7825,9766,4776,ITF,ITF3,15,Campania
2021-03-14,VDA,392,200,192,392,0,ITC,ITC2,2,Valle d'Aosta / Vallée d'Aoste
2021-05-11,CAL,15125,7314,7811,10349,4776,ITF,ITF6,18,Calabria
2021-03-18,PAB,1302,531,771,226,1076,ITH,ITH1,4,Provincia Autonoma Bolzano / Bozen
2021-03-05,UMB,4592,1379,3213,3936,656,ITI,ITI2,10,Umbria
2021-05-21,PUG,37842,17712,20130,28181,9661,ITF,ITF4,16,Puglia
2021-02-19,PIE,5535,2175,3360,5034,501,ITC,ITC1,1,Piemonte
2021-03-04,MOL,850,417,433,526,324,ITF,ITF2,14,Molise
2021-01-19,SIC,1304,541,763,1096,208,ITG,ITG1,19,Sicilia
2021-03-03,SIC,14663,6522,8141,11575,3088,ITG,ITG1,19,Sicilia
2021-01-19,LAZ,4768,1954,2814,4314,454,ITI,ITI4,12,Lazio
2021-05-22,BAS,5488,2723,2765,1937,3551,ITF,ITF5,17,Basilicata
2021-02-17,FVG,2353,999,1354,1873,480,ITH,ITH4,6,Friuli-Venezia Giulia
2021-01-29,LIG,3079,1064,2015,67,3012,ITC,ITC3,7,Liguria
2021-04-03,PAT,1138,471,667,971,167,ITH,ITH2,4,Provincia Autonoma Trento
2021-01-20,MOL,18,8,10,18,0,ITF,ITF2,14,Molise
2021-01-24,CAL,44,18,26,39,5,ITF,ITF6,18,Calabria
2021-05-11,CAM,39830,19229,20601,30461,9369,ITF,ITF3,15,Campania
2021-03-22,VEN,18093,8134,9959,13050,5043,ITH,ITH3,5,Veneto
2021-03-15,EMR,13268,6091,7177,6769,6499,ITH,ITH5,8,Emilia-Romagna
2021-05-22,ABR,13066,6349,6717,8165,4901,ITF,ITF1,13,Abruzzo
2021-05-30,FVG,11038,4978,6060,7459,3579,ITH,ITH4,6,Friuli-Venezia Giulia
2021-02-08,PUG,3992,1610,2382,1597,2395,ITF,ITF4,16,Puglia
2021-04-24,PAT,3507,1682,1825,3494,13,ITH,ITH2,4,Provincia Autonoma Trento
2021-05-01,SIC,24474,11326,13148,19316,5158,ITG,ITG1,19,Sicilia
2021-05-20,VEN,44410,21088,23322,20241,24169,ITH,ITH3,5,Veneto
2021-03-29,TOS,9391,4588,4803,9067,324,ITI,ITI1,9,Toscana
2021-02-13,BAS,799,313,486,738,61,ITF,ITF5,17,Basilicata
2021-02-03,PAB,1503,478,1025,5,1498,ITH,ITH1,4,Provincia Autonoma Bolzano / Bozen
2021-01-29,MAR,1990,729,1261,167,1823,ITI,ITI3,11,Marche
2021-03-17,SAR,6556,2849,3707,4949,1607,ITG,ITG2,20,Sardegna
2021-02-23,CAL,1590,753,837,1475,115,ITF,ITF6,18,Calabria
2021-05-08,UMB,8100,3730,4370,4904,3196,ITI,ITI2,10,Umbria
2021-03-23,VDA,379,150,229,245,134,ITC,ITC2,2,Valle d'Aosta / Vallée d'Aoste
2021-02-04,EMR,9938,3207,6731,1250,8688,ITH,ITH5,8,Emilia-Romagna
2021-05-22,EMR,32831,14073,18758,16855,15976,ITH,ITH5,8,Emilia-Romagna
2021-05-03,UMB,5091,2271,2820,2204,2887,ITI,ITI2,10,Umbria
2021-04-18,BAS,3720,1847,1873,2353,1367,ITF,ITF5,17,Basilicata
2021-04-09,EMR,25505,11567,13938,19814,5691,ITH,ITH5,8,Emilia-Romagna
2021-02-17,PUG,4272,1744,2528,3670,602,ITF,ITF4,16,Puglia
2021-04-07,CAM,24753,11780,12973,20031,4722,ITF,ITF3,15,Campania
2021-05-21,PAB,6843,3737,3106,5065,1778,ITH,ITH1,4,Provincia Autonoma Bolzano / Bozen
2021-02-07,VEN,2315,862,1453,714,1601,ITH,ITH3,5,Veneto
2021-02-19,PAT,928,358,570,869,59,ITH,ITH2,4,Provincia Autonoma Trento
2021-04-24,PIE,27447,12419,15028,21808,5639,ITC,ITC1,1,Piemonte
2021-01-21,UMB,610,202,408,341,269,ITI,ITI2,10,Umbria
2021-05-06,LOM,89715,42156,47559,73292,16423,ITC,ITC4,3,Lombardia
2021-05-11,LIG,13671,6177,7494,7069,6602,ITC,ITC3,7,Liguria
2021-04-02,CAM,21730,10411,11319,19409,2321,ITF,ITF3,15,Campania
2021-05-16,PAB,2024,931,1093,1330,694,ITH,ITH1,4,Provincia Autonoma Bolzano / Bozen
2021-05-02,MOL,1890,930,960,587,1303,ITF,ITF2,14,Molise
2021-04-26,FVG,5455,2449,3006,3806,1649,ITH,ITH4,6,Friuli-Venezia Giulia
2021-03-29,LIG,10437,4509,5928,7308,3129,ITC,ITC3,7,Liguria
2021-02-14,TOS,9000,2569,6431,8890,110,ITI,ITI1,9,Toscana
2021-03-26,SAR,8091,3180,4911,6566,1525,ITG,ITG2,20,Sardegna
2021-04-02,LAZ,28546,13375,15171,21218,7328,ITI,ITI4,12,Lazio
2021-05-15,LOM,80559,38676,41883,47332,33227,ITC,ITC4,3,Lombardia
2021-04-07,CAL,6516,2944,3572,3716,2800,ITF,ITF6,18,Calabria
2021-02-08,VDA,223,83,140,25,198,ITC,ITC2,2,Valle d'Aosta / Vallée d'Aoste
2021-02-09,EMR,4153,1248,2905,2307,1846,ITH,ITH5,8,Emilia-Romagna
2021-02-28,PAT,242,121,121,242,0,ITH,ITH2,4,Provincia Autonoma Trento
2021-05-10,SIC,28317,13596,14721,16189,12128,ITG,ITG1,19,Sicilia
2021-01-28,LAZ,8279,3165,5114,782,7497,ITI,ITI4,12,Lazio
2021-02-02,CAM,5723,2804,2919,444,5279,ITF,ITF3,15,Campania
2021-01-29,MOL,421,136,285,6,415,ITF,ITF2,14,Molise
2021-02-02,LOM,19865,6590,13275,498,19367,ITC,ITC4,3,Lombardia
2021-01-14,FVG,2584,789,1795,2584,0,ITH,ITH4,6,Friuli-Venezia Giulia
2021-01-28,SIC,9313,4394,4919,398,8915,ITG,ITG1,19,Sicilia
2021-05-11,MOL,3205,1413,1792,2955,250,ITF,ITF2,14,Molise
2021-05-03,PIE,26646,12161,14485,12508,14138,ITC,ITC1,1,Piemonte
2021-05-31,BAS,4068,1937,2131,1701,2367,ITF,ITF5,17,Basilicata
2021-01-12,PUG,4212,1772,2440,4212,0,ITF,ITF4,16,Puglia
2021-02-16,LOM,9512,3077,6435,9060,452,ITC,ITC4,3,Lombardia
2021-01-25,CAL,1069,513,556,147,922,ITF,ITF6,18,Calabria
2021-04-26,TOS,10153,4943,5210,7598,2555,ITI,ITI1,9,Toscana
2021-03-20,VDA,208,86,122,172,36,ITC,ITC2,2,Valle d'Aosta / Vallée d'Aoste
2021-01-02,TOS,3497,1096,2401,3497,0,ITI,ITI1,9,Toscana
2021-05-24,UMB,9015,4480,4535,8169,846,ITI,ITI2,10,Umbria
2021-05-06,MOL,2679,1214,1465,2081,598,ITF,ITF2,14,Molise
2021-03-20,BAS,1287,567,720,275,1012,ITF,ITF5,17,Basilicata
2020-12-28,LOM,107,47,60,107,0,ITC,ITC4,3,Lombardia
2021-04-21,LOM,71656,32503,39153,57068,14588,ITC,ITC4,3,Lombardia
2021-03-07,TOS,5647,2357,3290,2105,3542,ITI,ITI1,9,Toscana
2021-04-04,UMB,59,20,39,23,36,ITI,ITI2,10,Umbria
2021-05-09,VDA,574,287,287,444,130,ITC,ITC2,2,Valle d'Aosta / Vallée d'Aoste
2021-01-04,LAZ,7481,2908,4573,7481,0,ITI,ITI4,12,Lazio
2021-05-26,CAM,52017,25394,26623,21145,30872,ITF,ITF3,15,Campania
2021-01-29,BAS,615,230,385,63,552,ITF,ITF5,17,Basilicata
2021-03-02,CAM,12757,4554,8203,8412,4345,ITF,ITF3,15,Campania
2021-01-11,CAL,2158,1042,1116,2158,0,ITF,ITF6,18,Calabria
2020-12-27,ABR,37,19,18,37,0,ITF,ITF1,13,Abruzzo
2021-01-15,BAS,813,350,463,813,0,ITF,ITF5,17,Basilicata
2021-05-05,CAL,13597,6507,7090,8488,5109,ITF,ITF6,18,Calabria
2021-03-02,LOM,22807,9696,13111,19770,3037,ITC,ITC4,3,Lombardia
2021-01-16,TOS,3271,1046,2225,3271,0,ITI,ITI1,9,Toscana
2021-04-03,VDA,676,341,335,661,15,ITC,ITC2,2,Valle d'Aosta / Vallée d'Aoste
2021-03-30,LAZ,25255,11584,13671,18107,7148,ITI,ITI4,12,Lazio
2021-02-13,UMB,115,28,87,112,3,ITI,ITI2,10,Umbria
2021-04-18,UMB,1530,680,850,600,930,ITI,ITI2,10,Umbria
2021-04-07,PUG,15328,6790,8538,8656,6672,ITF,ITF4,16,Puglia
2021-03-28,EMR,13456,6001,7455,9592,3864,ITH,ITH5,8,Emilia-Romagna
2021-01-26,MOL,450,184,266,8,442,ITF,ITF2,14,Molise
2021-03-02,LIG,4074,1689,2385,3764,310,ITC,ITC3,7,Liguria
2021-01-11,CAM,4072,1871,2201,4072,0,ITF,ITF3,15,Campania
2021-03-02,CAL,4369,2490,1879,3613,756,ITF,ITF6,18,Calabria
2021-03-16,CAL,3835,1883,1952,2175,1660,ITF,ITF6,18,Calabria
2021-03-06,BAS,1354,536,818,758,596,ITF,ITF5,17,Basilicata
2021-05-23,VDA,999,465,534,658,341,ITC,ITC2,2,Valle d'Aosta / Vallée d'Aoste
2021-01-11,LOM,16170,5361,10809,16170,0,ITC,ITC4,3,Lombardia
2021-05-19,LAZ,46447,21210,25237,36638,9809,ITI,ITI4,12,Lazio
2021-01-29,VDA,318,138,180,2,316,ITC,ITC2,2,Valle d'Aosta / Vallée d'Aoste
2021-02-06,EMR,7601,2407,5194,2131,5470,ITH,ITH5,8,Emilia-Romagna
2021-03-17,MOL,908,385,523,576,332,ITF,ITF2,14,Molise
2021-05-27,PUG,38933,17902,21031,22522,16411,ITF,ITF4,16,Puglia
2021-02-27,UMB,1658,354,1304,1642,16,ITI,ITI2,10,Umbria
2021-04-21,LIG,14244,6432,7812,8922,5322,ITC,ITC3,7,Liguria
2021-05-09,BAS,4686,2341,2345,2991,1695,ITF,ITF5,17,Basilicata
2021-05-05,LIG,13668,6122,7546,5251,8417,ITC,ITC3,7,Liguria
2021-02-27,SIC,12426,5557,6869,11222,1204,ITG,ITG1,19,Sicilia
2021-05-27,ABR,12921,5874,7047,8240,4681,ITF,ITF1,13,Abruzzo
2021-05-03,PAB,1830,847,983,417,1413,ITH,ITH1,4,Provincia Autonoma Bolzano / Bozen
2021-06-02,PIE,26450,12973,13477,22034,4416,ITC,ITC1,1,Piemonte
2021-03-05,BAS,1855,857,998,1109,746,ITF,ITF5,17,Basilicata
2021-05-19,PAT,5090,2452,2638,3840,1250,ITH,ITH2,4,Provincia Autonoma Trento
2020-12-27,CAM,720,422,298,720,0,ITF,ITF3,15,Campania
2021-03-01,CAL,2723,1545,1178,2269,454,ITF,ITF6,18,Calabria
2021-04-20,CAM,32013,15491,16522,20707,11306,ITF,ITF3,15,Campania
2021-01-08,UMB,1190,345,845,1190,0,ITI,ITI2,10,Umbria
2021-04-28,MAR,10734,4890,5844,6003,4731,ITI,ITI3,11,Marche
2021-05-31,TOS,29990,14369,15621,19320,10670,ITI,ITI1,9,Toscana
2021-01-03,FVG,312,122,190,312,0,ITH,ITH4,6,Friuli-Venezia Giulia
2021-05-07,VEN,48128,23072,25056,39497,8631,ITH,ITH3,5,Veneto
2021-03-16,LIG,6073,2722,3351,2349,3724,ITC,ITC3,7,Liguria
2021-02-08,LAZ,9739,4153,5586,4508,5231,ITI,ITI4,12,Lazio
2021-04-25,SAR,4497,2269,2228,3718,779,ITG,ITG2,20,Sardegna
2021-04-07,ABR,7129,3282,3847,4404,2725,ITF,ITF1,13,Abruzzo
2021-04-18,SIC,19743,9872,9871,15377,4366,ITG,ITG1,19,Sicilia
2021-04-24,BAS,4544,2197,2347,3532,1012,ITF,ITF5,17,Basilicata
2021-02-12,VDA,263,96,167,217,46,ITC,ITC2,2,Valle d'Aosta / Vallée d'Aoste
2021-04-21,PUG,23055,10636,12419,19322,3733,ITF,ITF4,16,Puglia
2021-02-16,PUG,3379,1452,1927,2735,644,ITF,ITF4,16,Puglia
2021-05-26,LOM,93041,44340,48701,43493,49548,ITC,ITC4,3,Lombardia
2021-01-10,CAL,930,524,406,930,0,ITF,ITF6,18,Calabria
2021-03-01,CAM,12130,4247,7883,8017,4113,ITF,ITF3,15,Campania
2021-02-22,FVG,2485,1193,1292,2067,418,ITH,ITH4,6,Friuli-Venezia Giulia
2021-04-11,TOS,3642,1679,1963,3487,155,ITI,ITI1,9,Toscana
2021-01-11,LIG,2653,989,1664,2653,0,ITC,ITC3,7,Liguria
2021-01-25,LIG,2723,888,1835,478,2245,ITC,ITC3,7,Liguria
2021-01-23,PAB,197,117,80,0,197,ITH,ITH1,4,Provincia Autonoma Bolzano / Bozen
2021-04-03,UMB,2111,716,1395,1058,1053,ITI,ITI2,10,Umbria
2021-03-18,VEN,12608,5136,7472,7382,5226,ITH,ITH3,5,Veneto
2021-03-06,SAR,2639,1079,1560,858,1781,ITG,ITG2,20,Sardegna
2021-02-22,PIE,8482,3472,5010,7892,590,ITC,ITC1,1,Piemonte
2021-04-13,PAT,2553,1058,1495,2046,507,ITH,ITH2,4,Provincia Autonoma Trento
2021-05-17,PAB,3124,1506,1618,2440,684,ITH,ITH1,4,Provincia Autonoma Bolzano / Bozen
2021-03-02,PUG,16345,6070,10275,15045,1300,ITF,ITF4,16,Puglia
2021-04-06,CAM,24372,11420,12952,19848,4524,ITF,ITF3,15,Campania
2021-01-18,MAR,673,230,443,547,126,ITI,ITI3,11,Marche
2021-04-06,LOM,43039,17559,25480,25091,17948,ITC,ITC4,3,Lombardia
2021-02-20,TOS,4640,1789,2851,4127,513,ITI,ITI1,9,Toscana
2021-04-13,FVG,7362,3289,4073,5758,1604,ITH,ITH4,6,Friuli-Venezia Giulia
2021-01-22,SIC,1254,634,620,243,1011,ITG,ITG1,19,Sicilia
2021-05-23,UMB,5068,1855,3213,652,4416,ITI,ITI2,10,Umbria
2021-01-27,VEN,7138,2062,5076,241,6897,ITH,ITH3,5,Veneto
2021-01-08,SIC,8335,3868,4467,8335,0,ITG,ITG1,19,Sicilia
2021-01-15,SAR,1563,573,990,1563,0,ITG,ITG2,20,Sardegna
2021-03-14,PAB,758,336,422,25,733,ITH,ITH1,4,Provincia Autonoma Bolzano / Bozen
2021-05-09,SAR,6128,2874,3254,5202,926,ITG,ITG2,20,Sardegna
2021-04-09,SAR,12261,5436,6825,7909,4352,ITG,ITG2,20,Sardegna
2021-03-14,PIE,8205,3336,4869,5308,2897,ITC,ITC1,1,Piemonte
2021-05-10,PIE,28669,13737,14932,15655,13014,ITC,ITC1,1,Piemonte
2021-05-24,SIC,35601,17139,18462,15709,19892,ITG,ITG1,19,Sicilia
2021-03-16,FVG,3153,1287,1866,1073,2080,ITH,ITH4,6,Friuli-Venezia Giulia
2021-05-27,LIG,16340,8225,8115,12399,3941,ITC,ITC3,7,Liguria
2021-05-12,FVG,10672,4937,5735,9317,1355,ITH,ITH4,6,Friuli-Venezia Giulia
2021-01-24,ABR,50,22,28,6,44,ITF,ITF1,13,Abruzzo
2021-02-19,PAB,2252,512,1740,2241,11,ITH,ITH1,4,Provincia Autonoma Bolzano / Bozen
2021-02-04,SAR,2271,816,1455,916,1355,ITG,ITG2,20,Sardegna
2021-04-02,SAR,8987,3547,5440,5745,3242,ITG,ITG2,20,Sardegna
2021-05-17,SIC,32097,15459,16638,19346,12751,ITG,ITG1,19,Sicilia
2021-02-06,UMB,396,138,258,34,362,ITI,ITI2,10,Umbria
2021-03-14,PAT,107,65,42,20,87,ITH,ITH2,4,Provincia Autonoma Trento
2021-03-21,SIC,15206,7330,7876,11236,3970,ITG,ITG1,19,Sicilia
2021-05-19,FVG,11707,5741,5966,9475,2232,ITH,ITH4,6,Friuli-Venezia Giulia
2021-02-09,LIG,1936,689,1247,256,1680,ITC,ITC3,7,Liguria
2021-03-07,PAT,22,6,16,22,0,ITH,ITH2,4,Provincia Autonoma Trento
2021-03-29,MAR,5860,2567,3293,3435,2425,ITI,ITI3,11,Marche
2021-01-09,PAT,190,40,150,190,0,ITH,ITH2,4,Provincia Autonoma Trento
2021-02-20,EMR,5317,2094,3223,5054,263,ITH,ITH5,8,Emilia-Romagna
2021-02-04,SIC,6932,3187,3745,1455,5477,ITG,ITG1,19,Sicilia
2021-05-19,PIE,32921,15132,17789,21974,10947,ITC,ITC1,1,Piemonte
2021-02-13,SIC,3097,1164,1933,2841,256,ITG,ITG1,19,Sicilia
2021-01-30,PIE,5980,2136,3844,218,5762,ITC,ITC1,1,Piemonte
2021-02-26,PAB,1526,551,975,1496,30,ITH,ITH1,4,Provincia Autonoma Bolzano / Bozen
2021-02-16,LIG,2397,954,1443,2004,393,ITC,ITC3,7,Liguria
2021-02-25,VEN,7899,3339,4560,7294,605,ITH,ITH3,5,Veneto
2021-03-09,PAT,1581,589,992,938,643,ITH,ITH2,4,Provincia Autonoma Trento
2021-05-27,MAR,13729,6817,6912,9428,4301,ITI,ITI3,11,Marche
2021-05-04,ABR,10665,5004,5661,7048,3617,ITF,ITF1,13,Abruzzo
2021-03-08,ABR,5122,1666,3456,4150,972,ITF,ITF1,13,Abruzzo
2021-04-14,LIG,13028,5658,7370,10826,2202,ITC,ITC3,7,Liguria
2021-03-31,MAR,7374,3086,4288,4350,3024,ITI,ITI3,11,Marche
2021-04-09,VEN,31098,13693,17405,22761,8337,ITH,ITH3,5,Veneto
2021-06-01,PAB,3461,2244,1217,2038,1423,ITH,ITH1,4,Provincia Autonoma Bolzano / Bozen
2021-04-11,SAR,5393,2442,2951,4273,1120,ITG,ITG2,20,Sardegna
2021-03-16,PIE,10520,4268,6252,4463,6057,ITC,ITC1,1,Piemonte
2021-05-12,PIE,31696,15066,16630,18933,12763,ITC,ITC1,1,Piemonte
2021-03-01,ABR,3479,1386,2093,2727,752,ITF,ITF1,13,Abruzzo
2021-01-04,CAL,1051,517,534,1051,0,ITF,ITF6,18,Calabria
2021-02-06,SIC,5015,2189,2826,1463,3552,ITG,ITG1,19,Sicilia
2021-05-20,MOL,2572,1325,1247,2397,175,ITF,ITF2,14,Molise
2021-05-31,EMR,29053,13319,15734,17940,11113,ITH,ITH5,8,Emilia-Romagna
2021-03-14,FVG,1395,547,848,1143,252,ITH,ITH4,6,Friuli-Venezia Giulia
2021-04-04,SAR,1,0,1,0,1,ITG,ITG2,20,Sardegna
2021-05-12,PAT,3297,1491,1806,2114,1183,ITH,ITH2,4,Provincia Autonoma Trento
2021-06-03,MAR,9127,4762,4365,7616,1511,ITI,ITI3,11,Marche
2021-03-16,PAT,1391,506,885,608,783,ITH,ITH2,4,Provincia Autonoma Trento
2021-02-02,ABR,1780,672,1108,222,1558,ITF,ITF1,13,Abruzzo
2021-02-08,PIE,6916,2355,4561,666,6250,ITC,ITC1,1,Piemonte
2021-04-13,LAZ,25661,11869,13792,17955,7706,ITI,ITI4,12,Lazio
2021-01-01,SIC,816,437,379,816,0,ITG,ITG1,19,Sicilia
2021-03-31,ABR,6649,2880,3769,4581,2068,ITF,ITF1,13,Abruzzo
2021-04-14,MOL,1806,767,1039,1145,661,ITF,ITF2,14,Molise
2021-02-16,MOL,156,70,86,150,6,ITF,ITF2,14,Molise
2021-05-27,MOL,2825,1342,1483,1991,834,ITF,ITF2,14,Molise
2021-03-01,EMR,10092,3578,6514,7836,2256,ITH,ITH5,8,Emilia-Romagna
2021-05-04,EMR,28577,13383,15194,14924,13653,ITH,ITH5,8,Emilia-Romagna
2021-01-04,LIG,2615,854,1761,2615,0,ITC,ITC3,7,Liguria
2020-12-30,VEN,699,245,454,699,0,ITH,ITH3,5,Veneto
2021-02-16,MAR,1287,475,812,1257,30,ITI,ITI3,11,Marche
2021-01-01,SAR,32,17,15,32,0,ITG,ITG2,20,Sardegna
2021-02-27,SAR,1921,647,1274,1366,555,ITG,ITG2,20,Sardegna
2021-02-01,PIE,8645,3055,5590,579,8066,ITC,ITC1,1,Piemonte
2021-05-08,BAS,4834,2399,2435,3428,1406,ITF,ITF5,17,Basilicata
2021-04-10,VDA,404,190,214,399,5,ITC,ITC2,2,Valle d'Aosta / Vallée d'Aoste
2021-04-27,CAM,32130,15598,16532,24210,7920,ITF,ITF3,15,Campania
2021-02-09,MOL,359,170,189,197,162,ITF,ITF2,14,Molise
2021-04-27,EMR,32045,14830,17215,19584,12461,ITH,ITH5,8,Emilia-Romagna
2021-02-01,PAT,1220,335,885,92,1128,ITH,ITH2,4,Provincia Autonoma Trento
2021-03-04,VEN,12921,4830,8091,9449,3472,ITH,ITH3,5,Veneto
2021-04-26,PAB,1543,771,772,1538,5,ITH,ITH1,4,Provincia Autonoma Bolzano / Bozen
2021-02-23,MAR,3267,1397,1870,3211,56,ITI,ITI3,11,Marche
2021-01-15,EMR,7746,2403,5343,7746,0,ITH,ITH5,8,Emilia-Romagna
2021-05-13,ABR,11147,5041,6106,7186,3961,ITF,ITF1,13,Abruzzo
2021-05-12,PUG,36158,16068,20090,23787,12371,ITF,ITF4,16,Puglia
2021-01-03,LAZ,5250,1972,3278,5250,0,ITI,ITI4,12,Lazio
2021-01-04,MOL,314,131,183,314,0,ITF,ITF2,14,Molise
2021-02-01,FVG,2097,688,1409,16,2081,ITH,ITH4,6,Friuli-Venezia Giulia
2021-02-08,PAT,1151,318,833,342,809,ITH,ITH2,4,Provincia Autonoma Trento
2021-05-29,MOL,2289,1194,1095,1935,354,ITF,ITF2,14,Molise
2021-02-27,EMR,10967,3999,6968,9229,1738,ITH,ITH5,8,Emilia-Romagna
2021-04-25,EMR,22324,10222,12102,14816,7508,ITH,ITH5,8,Emilia-Romagna
2021-02-26,VDA,207,58,149,122,85,ITC,ITC2,2,Valle d'Aosta / Vallée d'Aoste
2021-01-16,PAB,2840,1265,1575,2840,0,ITH,ITH1,4,Provincia Autonoma Bolzano / Bozen
2021-05-05,PUG,38830,16969,21861,24699,14131,ITF,ITF4,16,Puglia
2020-12-31,VDA,18,4,14,18,0,ITC,ITC2,2,Valle d'Aosta / Vallée d'Aoste
2021-03-10,ABR,4977,1646,3331,4022,955,ITF,ITF1,13,Abruzzo
2021-01-26,ABR,1543,567,976,30,1513,ITF,ITF1,13,Abruzzo
2021-05-06,ABR,13068,6125,6943,8009,5059,ITF,ITF1,13,Abruzzo
2021-02-08,FVG,2357,694,1663,92,2265,ITH,ITH4,6,Friuli-Venezia Giulia
2021-01-10,LAZ,4039,1700,2339,4039,0,ITI,ITI4,12,Lazio
2021-04-20,LAZ,30996,14226,16770,19715,11281,ITI,ITI4,12,Lazio
2021-03-05,VDA,275,124,151,53,222,ITC,ITC2,2,Valle d'Aosta / Vallée d'Aoste
2021-03-08,LAZ,20074,8321,11753,14801,5273,ITI,ITI4,12,Lazio
2021-03-22,CAM,12740,5921,6819,10700,2040,ITF,ITF3,15,Campania
2021-05-18,MOL,1645,877,768,990,655,ITF,ITF2,14,Molise
2021-03-22,MOL,1146,439,707,903,243,ITF,ITF2,14,Molise
2021-05-04,BAS,4137,1991,2146,3614,523,ITF,ITF5,17,Basilicata
2021-03-08,BAS,1456,710,746,844,612,ITF,ITF5,17,Basilicata
2021-04-07,TOS,35635,15293,20342,28387,7248,ITI,ITI1,9,Toscana
2021-01-06,CAL,930,502,428,930,0,ITF,ITF6,18,Calabria
2021-02-26,PUG,13714,5027,8687,12680,1034,ITF,ITF4,16,Puglia
2020-12-31,PUG,1634,782,852,1634,0,ITF,ITF4,16,Puglia
2021-05-17,LAZ,43781,19995,23786,35335,8446,ITI,ITI4,12,Lazio
2021-02-03,VDA,351,114,237,14,337,ITC,ITC2,2,Valle d'Aosta / Vallée d'Aoste
2021-04-01,VDA,776,394,382,764,12,ITC,ITC2,2,Valle d'Aosta / Vallée d'Aoste
2021-05-19,UMB,9390,4197,5193,5651,3739,ITI,ITI2,10,Umbria
2021-03-26,LOM,41152,15604,25548,28077,13075,ITC,ITC4,3,Lombardia
2021-05-22,LOM,70273,33707,36566,32349,37924,ITC,ITC4,3,Lombardia
2021-02-11,LAZ,6998,3012,3986,6467,531,ITI,ITI4,12,Lazio
2021-01-06,CAM,7652,3749,3903,7652,0,ITF,ITF3,15,Campania
2021-05-29,LOM,87792,42158,45634,42016,45776,ITC,ITC4,3,Lombardia
2021-03-01,BAS,547,284,263,381,166,ITF,ITF5,17,Basilicata
2021-01-13,CAL,2033,1023,1010,2033,0,ITF,ITF6,18,Calabria
2021-04-08,VDA,584,282,302,441,143,ITC,ITC2,2,Valle d'Aosta / Vallée d'Aoste
2021-05-24,LAZ,42813,19171,23642,34024,8789,ITI,ITI4,12,Lazio
2021-04-14,TOS,20159,8334,11825,15050,5109,ITI,ITI1,9,Toscana
2021-05-25,MOL,1960,885,1075,1330,630,ITF,ITF2,14,Molise
2021-02-07,MOL,66,32,34,19,47,ITF,ITF2,14,Molise
2021-05-24,LOM,89135,43248,45887,49430,39705,ITC,ITC4,3,Lombardia
2021-02-18,EMR,7039,2892,4147,6456,583,ITH,ITH5,8,Emilia-Romagna
2021-03-05,PUG,17315,6870,10445,15068,2247,ITF,ITF4,16,Puglia
2021-02-11,LOM,17042,5002,12040,9696,7346,ITC,ITC4,3,Lombardia
2021-03-23,UMB,3797,1685,2112,2168,1629,ITI,ITI2,10,Umbria
2021-02-11,CAM,6278,2704,3574,6212,66,ITF,ITF3,15,Campania
2021-04-16,CAL,10297,5008,5289,8645,1652,ITF,ITF6,18,Calabria
2021-02-08,UMB,637,203,434,88,549,ITI,ITI2,10,Umbria
2021-02-18,CAL,1822,825,997,1596,226,ITF,ITF6,18,Calabria
2021-02-06,LAZ,6136,2474,3662,817,5319,ITI,ITI4,12,Lazio
2021-05-31,LOM,95182,47153,48029,79275,15907,ITC,ITC4,3,Lombardia
2021-05-29,LIG,6799,3224,3575,3960,2839,ITC,ITC3,7,Liguria
2021-04-16,TOS,28955,12889,16066,22045,6910,ITI,ITI1,9,Toscana
2021-04-16,CAM,34302,16551,17751,23644,10658,ITF,ITF3,15,Campania
2021-04-11,LAZ,19115,8431,10684,13234,5881,ITI,ITI4,12,Lazio
2021-04-23,CAL,12900,6337,6563,9442,3458,ITF,ITF6,18,Calabria
2021-02-13,LAZ,6608,2626,3982,6194,414,ITI,ITI4,12,Lazio
2021-04-13,BAS,2113,1052,1061,1295,818,ITF,ITF5,17,Basilicata
2021-02-18,LOM,14035,4922,9113,13016,1019,ITC,ITC4,3,Lombardia
2021-02-24,VDA,183,82,101,164,19,ITC,ITC2,2,Valle d'Aosta / Vallée d'Aoste
2021-03-02,TOS,10598,3798,6800,7154,3444,ITI,ITI1,9,Toscana
2021-01-04,TOS,5065,1894,3171,5065,0,ITI,ITI1,9,Toscana
2021-05-26,UMB,9609,4545,5064,8379,1230,ITI,ITI2,10,Umbria
2021-02-18,CAM,9080,3812,5268,8372,708,ITF,ITF3,15,Campania
2021-02-28,PUG,6046,1806,4240,5860,186,ITF,ITF4,16,Puglia
2021-04-08,FVG,7211,3016,4195,5289,1922,ITH,ITH4,6,Friuli-Venezia Giulia
2021-04-23,LIG,14672,6637,8035,8552,6120,ITC,ITC3,7,Liguria
2021-05-29,MAR,12789,6195,6594,8261,4528,ITI,ITI3,11,Marche
2021-02-10,FVG,1352,496,856,1266,86,ITH,ITH4,6,Friuli-Venezia Giulia
2021-05-15,ABR,11422,5174,6248,6126,5296,ITF,ITF1,13,Abruzzo
2021-05-28,UMB,9471,4355,5116,7252,2219,ITI,ITI2,10,Umbria
2021-05-13,BAS,5982,2966,3016,3385,2597,ITF,ITF5,17,Basilicata
2021-01-08,LAZ,7728,2894,4834,7728,0,ITI,ITI4,12,Lazio
2021-03-04,TOS,17625,6759,10866,14543,3082,ITI,ITI1,9,Toscana
2021-05-03,PUG,33105,14778,18327,22486,10619,ITF,ITF4,16,Puglia
2021-03-07,PUG,4921,1943,2978,4350,571,ITF,ITF4,16,Puglia
2021-04-13,UMB,7678,3399,4279,6009,1669,ITI,ITI2,10,Umbria
2021-02-03,FVG,2647,791,1856,23,2624,ITH,ITH4,6,Friuli-Venezia Giulia
2021-02-15,UMB,1368,692,676,1367,1,ITI,ITI2,10,Umbria
2021-01-15,CAL,2795,1258,1537,2795,0,ITF,ITF6,18,Calabria
2021-02-20,LOM,9339,3867,5472,9042,297,ITC,ITC4,3,Lombardia
2021-04-18,LOM,36342,16203,20139,31114,5228,ITC,ITC4,3,Lombardia
2021-04-16,LIG,11969,5279,6690,10159,1810,ITC,ITC3,7,Liguria
2021-01-06,TOS,4520,1460,3060,4520,0,ITI,ITI1,9,Toscana
2021-05-26,SIC,44243,20626,23617,23789,20454,ITG,ITG1,19,Sicilia
2021-05-14,PIE,33272,16191,17081,17914,15358,ITC,ITC1,1,Piemonte
2021-04-13,SIC,19903,9684,10219,11068,8835,ITG,ITG1,19,Sicilia
2021-01-01,LAZ,3554,1382,2172,3554,0,ITI,ITI4,12,Lazio
2021-01-15,CAM,4980,2381,2599,4980,0,ITF,ITF3,15,Campania
2021-03-13,CAM,14250,6795,7455,8968,5282,ITF,ITF3,15,Campania
2021-01-26,BAS,797,352,445,101,696,ITF,ITF5,17,Basilicata
2021-03-20,CAL,6695,3069,3626,4195,2500,ITF,ITF6,18,Calabria
2021-05-14,PAT,5301,2535,2766,3931,1370,ITH,ITH2,4,Provincia Autonoma Trento
2021-04-25,CAM,30732,15172,15560,25340,5392,ITF,ITF3,15,Campania
2021-04-20,SIC,19281,9087,10194,13942,5339,ITG,ITG1,19,Sicilia
2021-02-18,MAR,2101,745,1356,1815,286,ITI,ITI3,11,Marche
2021-05-21,FVG,11054,4920,6134,8168,2886,ITH,ITH4,6,Friuli-Venezia Giulia
2021-01-24,BAS,837,300,537,58,779,ITF,ITF5,17,Basilicata
2021-05-02,VEN,37220,17254,19966,26885,10335,ITH,ITH3,5,Veneto
2021-03-11,LIG,6351,3053,3298,4345,2006,ITC,ITC3,7,Liguria
2021-01-13,LIG,2754,1013,1741,2754,0,ITC,ITC3,7,Liguria
2021-01-13,CAM,8020,3666,4354,8020,0,ITF,ITF3,15,Campania
2021-04-15,UMB,7628,3483,4145,5742,1886,ITI,ITI2,10,Umbria
2021-03-06,VEN,10627,4316,6311,7365,3262,ITH,ITH3,5,Veneto
2021-04-28,PAB,2464,1302,1162,2459,5,ITH,ITH1,4,Provincia Autonoma Bolzano / Bozen
2021-05-21,PIE,35840,16607,19233,20356,15484,ITC,ITC1,1,Piemonte
2021-02-17,UMB,1618,748,870,1267,351,ITI,ITI2,10,Umbria
2021-01-23,PUG,3040,1294,1746,886,2154,ITF,ITF4,16,Puglia
2021-03-13,CAL,6842,2988,3854,5873,969,ITF,ITF6,18,Calabria
2021-05-14,FVG,10597,5247,5350,8124,2473,ITH,ITH4,6,Friuli-Venezia Giulia
2021-02-25,MAR,3510,1434,2076,3331,179,ITI,ITI3,11,Marche
2021-04-18,CAM,27216,13281,13935,18318,8898,ITF,ITF3,15,Campania
2021-01-08,CAM,10455,4968,5487,10455,0,ITF,ITF3,15,Campania
2021-02-25,ABR,3042,1330,1712,2514,528,ITF,ITF1,13,Abruzzo
2021-03-08,SIC,13534,5824,7710,10728,2806,ITG,ITG1,19,Sicilia
2021-03-20,PAT,873,402,471,670,203,ITH,ITH2,4,Provincia Autonoma Trento
2021-05-16,LOM,68483,32408,36075,36482,32001,ITC,ITC4,3,Lombardia
2021-03-05,EMR,17685,5752,11933,14235,3450,ITH,ITH5,8,Emilia-Romagna
2021-02-12,FVG,1193,428,765,1146,47,ITH,ITH4,6,Friuli-Venezia Giulia
2021-04-01,TOS,26904,11107,15797,16301,10603,ITI,ITI1,9,Toscana
2021-03-08,VEN,13549,6195,7354,9480,4069,ITH,ITH3,5,Veneto
2021-05-11,SIC,32429,15425,17004,19887,12542,ITG,ITG1,19,Sicilia
2021-02-17,SIC,5414,3278,2136,4746,668,ITG,ITG1,19,Sicilia
2021-05-30,LAZ,41027,17512,23515,33803,7224,ITI,ITI4,12,Lazio
2021-05-31,MOL,2234,1067,1167,1916,318,ITF,ITF2,14,Molise
2021-05-23,PIE,28683,13125,15558,15748,12935,ITC,ITC1,1,Piemonte
2021-02-23,BAS,1901,771,1130,1763,138,ITF,ITF5,17,Basilicata
2021-03-13,LOM,27174,9766,17408,21079,6095,ITC,ITC4,3,Lombardia
2021-01-03,SAR,90,36,54,90,0,ITG,ITG2,20,Sardegna
2021-03-03,FVG,3639,1627,2012,2365,1274,ITH,ITH4,6,Friuli-Venezia Giulia
2021-02-03,LIG,2314,790,1524,55,2259,ITC,ITC3,7,Liguria
2021-02-06,ABR,1611,743,868,602,1009,ITF,ITF1,13,Abruzzo
2021-03-10,UMB,4013,1927,2086,2757,1256,ITI,ITI2,10,Umbria
2021-03-27,VEN,32048,13987,18061,26243,5805,ITH,ITH3,5,Veneto
2021-01-27,TOS,4835,1573,3262,206,4629,ITI,ITI1,9,Toscana
2021-03-03,PIE,12120,4644,7476,11301,819,ITC,ITC1,1,Piemonte
2021-03-29,SAR,4425,1559,2866,3837,588,ITG,ITG2,20,Sardegna
2021-05-13,UMB,5897,2656,3241,3824,2073,ITI,ITI2,10,Umbria
2021-03-14,ABR,1883,731,1152,1216,667,ITF,ITF1,13,Abruzzo
2021-01-05,SAR,1327,446,881,1327,0,ITG,ITG2,20,Sardegna
2021-02-12,PAT,1010,340,670,589,421,ITH,ITH2,4,Provincia Autonoma Trento
2021-05-16,LIG,3693,1855,1838,2133,1560,ITC,ITC3,7,Liguria
2021-02-05,CAM,7260,3463,3797,2133,5127,ITF,ITF3,15,Campania
2021-03-03,PAT,1656,622,1034,1139,517,ITH,ITH2,4,Provincia Autonoma Trento
2021-02-05,LOM,25623,7443,18180,2391,23232,ITC,ITC4,3,Lombardia
2021-04-10,CAL,11361,5125,6236,6559,4802,ITF,ITF6,18,Calabria
2021-02-27,MAR,3356,1435,1921,3147,209,ITI,ITI3,11,Marche
2021-03-31,BAS,3095,1258,1837,2313,782,ITF,ITF5,17,Basilicata
2021-05-13,SIC,47385,22235,25150,30784,16601,ITG,ITG1,19,Sicilia
2021-05-26,PAB,4797,2421,2376,2845,1952,ITH,ITH1,4,Provincia Autonoma Bolzano / Bozen
2021-04-24,LAZ,33338,15026,18312,20590,12748,ITI,ITI4,12,Lazio
2021-01-31,SIC,4109,1959,2150,113,3996,ITG,ITG1,19,Sicilia
2021-03-03,EMR,15829,5250,10579,13353,2476,ITH,ITH5,8,Emilia-Romagna
2021-02-20,MOL,1018,441,577,998,20,ITF,ITF2,14,Molise
2021-05-17,ABR,11026,5038,5988,6167,4859,ITF,ITF1,13,Abruzzo
2021-05-06,PIE,33218,15630,17588,19760,13458,ITC,ITC1,1,Piemonte
2021-02-12,PIE,6891,2215,4676,3930,2961,ITC,ITC1,1,Piemonte
2021-06-03,BAS,3083,1403,1680,2457,626,ITF,ITF5,17,Basilicata
2021-02-05,CAL,3800,1710,2090,490,3310,ITF,ITF6,18,Calabria
2021-06-02,MOL,2618,1281,1337,2592,26,ITF,ITF2,14,Molise
2021-03-18,MAR,3389,1475,1914,162,3227,ITI,ITI3,11,Marche
2021-01-04,VDA,142,59,83,142,0,ITC,ITC2,2,Valle d'Aosta / Vallée d'Aoste
2021-05-23,MAR,9208,4282,4926,7537,1671,ITI,ITI3,11,Marche
2021-01-21,CAM,2092,1115,977,676,1416,ITF,ITF3,15,Campania
2021-03-13,PUG,10387,4104,6283,8655,1732,ITF,ITF4,16,Puglia
2021-05-01,LOM,95878,43645,52233,66746,29132,ITC,ITC4,3,Lombardia
2021-02-15,PAB,72,42,30,26,46,ITH,ITH1,4,Provincia Autonoma Bolzano / Bozen
2021-03-26,CAL,7896,3737,4159,4778,3118,ITF,ITF6,18,Calabria
2021-02-02,UMB,944,274,670,32,912,ITI,ITI2,10,Umbria
2021-03-17,TOS,11421,4586,6835,6893,4528,ITI,ITI1,9,Toscana
2021-02-05,LIG,2673,986,1687,304,2369,ITC,ITC3,7,Liguria
2021-02-10,MAR,1439,452,987,1080,359,ITI,ITI3,11,Marche
2021-02-16,EMR,5768,2444,3324,5237,531,ITH,ITH5,8,Emilia-Romagna
2021-01-14,LAZ,5473,2142,3331,5473,0,ITI,ITI4,12,Lazio
2021-03-31,SAR,10154,4050,6104,7707,2447,ITG,ITG2,20,Sardegna
2021-02-02,SIC,5534,2620,2914,629,4905,ITG,ITG1,19,Sicilia
2021-02-08,BAS,557,193,364,151,406,ITF,ITF5,17,Basilicata
2021-03-09,VDA,206,96,110,174,32,ITC,ITC2,2,Valle d'Aosta / Vallée d'Aoste
2021-04-26,LAZ,29181,13432,15749,19979,9202,ITI,ITI4,12,Lazio
2021-02-19,VEN,7322,3140,4182,7118,204,ITH,ITH3,5,Veneto
2021-03-26,CAM,19458,8929,10529,15644,3814,ITF,ITF3,15,Campania
2021-01-20,ABR,447,156,291,445,2,ITF,ITF1,13,Abruzzo
2021-01-28,FVG,2239,794,1445,354,1885,ITH,ITH4,6,Friuli-Venezia Giulia
2021-01-26,PIE,6331,1879,4452,735,5596,ITC,ITC1,1,Piemonte
2021-04-10,LIG,7883,3556,4327,6969,914,ITC,ITC3,7,Liguria
2021-05-02,ABR,10424,5088,5336,5214,5210,ITF,ITF1,13,Abruzzo
2021-05-28,PAB,5623,2853,2770,3775,1848,ITH,ITH1,4,Provincia Autonoma Bolzano / Bozen
2021-04-21,EMR,23919,10952,12967,14184,9735,ITH,ITH5,8,Emilia-Romagna
2021-06-01,VEN,26668,13381,13287,16355,10313,ITH,ITH3,5,Veneto
2021-05-08,PIE,34117,16184,17933,18488,15629,ITC,ITC1,1,Piemonte
2021-01-28,EMR,10250,3339,6911,349,9901,ITH,ITH5,8,Emilia-Romagna
2021-05-16,PUG,24356,10985,13371,12586,11770,ITF,ITF4,16,Puglia
2021-03-11,VDA,197,76,121,66,131,ITC,ITC2,2,Valle d'Aosta / Vallée d'Aoste
2021-02-12,MAR,1582,618,964,1430,152,ITI,ITI3,11,Marche
2021-01-21,LOM,5319,1564,3755,4631,688,ITC,ITC4,3,Lombardia
2021-06-02,VDA,1215,688,527,814,401,ITC,ITC2,2,Valle d'Aosta / Vallée d'Aoste
2021-05-18,PUG,28221,12940,15281,15644,12577,ITF,ITF4,16,Puglia
2021-05-01,CAM,46319,22654,23665,30221,16098,ITF,ITF3,15,Campania
2021-05-27,EMR,36478,15986,20492,8729,27749,ITH,ITH5,8,Emilia-Romagna
2021-05-08,PAT,3153,1721,1432,2734,419,ITH,ITH2,4,Provincia Autonoma Trento
2021-05-19,BAS,2870,1498,1372,1194,1676,ITF,ITF5,17,Basilicata
2021-04-22,PAB,2923,1500,1423,1981,942,ITH,ITH1,4,Provincia Autonoma Bolzano / Bozen
2021-04-30,ABR,12393,5805,6588,6703,5690,ITF,ITF1,13,Abruzzo
2021-01-16,LAZ,5645,2280,3365,5645,0,ITI,ITI4,12,Lazio
2021-04-27,MOL,1593,767,826,465,1128,ITF,ITF2,14,Molise
2021-05-08,FVG,10252,4635,5617,5474,4778,ITH,ITH4,6,Friuli-Venezia Giulia
2020-12-31,LIG,989,354,635,989,0,ITC,ITC3,7,Liguria
2021-04-28,UMB,5346,2317,3029,2964,2382,ITI,ITI2,10,Umbria
2021-02-21,VEN,4633,1209,3424,4628,5,ITH,ITH3,5,Veneto
2021-05-16,MOL,1246,570,676,1064,182,ITF,ITF2,14,Molise
2021-03-15,UMB,4596,1930,2666,2828,1768,ITI,ITI2,10,Umbria
2021-05-25,ABR,11213,5195,6018,8091,3122,ITF,ITF1,13,Abruzzo
2021-02-10,UMB,715,349,366,700,15,ITI,ITI2,10,Umbria
2021-05-09,VEN,34934,16059,18875,24873,10061,ITH,ITH3,5,Veneto
2021-05-31,MAR,11780,5941,5839,8851,2929,ITI,ITI3,11,Marche
2021-05-02,FVG,6838,3210,3628,3939,2899,ITH,ITH4,6,Friuli-Venezia Giulia
2021-01-12,BAS,217,88,129,217,0,ITF,ITF5,17,Basilicata
2021-04-23,PUG,29323,13624,15699,24117,5206,ITF,ITF4,16,Puglia
2021-05-04,LAZ,39750,18279,21471,26274,13476,ITI,ITI4,12,Lazio
2021-04-18,LIG,2613,1164,1449,2145,468,ITC,ITC3,7,Liguria
2021-02-17,SAR,1407,577,830,1333,74,ITG,ITG2,20,Sardegna
2021-04-30,MAR,13939,6100,7839,5398,8541,ITI,ITI3,11,Marche
2021-01-06,PAB,59,18,41,59,0,ITH,ITH1,4,Provincia Autonoma Bolzano / Bozen
2021-01-30,ABR,1510,567,943,69,1441,ITF,ITF1,13,Abruzzo
2021-04-05,CAM,11638,5543,6095,9215,2423,ITF,ITF3,15,Campania
2021-04-08,LOM,52314,21751,30563,35862,16452,ITC,ITC4,3,Lombardia
2021-02-05,PIE,9601,3138,6463,659,8942,ITC,ITC1,1,Piemonte
2021-02-24,LAZ,12046,5204,6842,11052,994,ITI,ITI4,12,Lazio
2021-05-04,SIC,26854,12474,14380,17634,9220,ITG,ITG1,19,Sicilia
2021-01-24,UMB,258,106,152,1,257,ITI,ITI2,10,Umbria
2021-01-26,CAL,1808,861,947,278,1530,ITF,ITF6,18,Calabria
2021-01-22,PAT,1668,433,1235,329,1339,ITH,ITH2,4,Provincia Autonoma Trento
2021-01-27,LIG,1744,603,1141,141,1603,ITC,ITC3,7,Liguria
2021-03-04,PUG,15113,5903,9210,13715,1398,ITF,ITF4,16,Puglia
2021-05-21,LIG,12831,5950,6881,9706,3125,ITC,ITC3,7,Liguria
2021-01-28,VDA,290,123,167,56,234,ITC,ITC2,2,Valle d'Aosta / Vallée d'Aoste
2021-03-11,MAR,6591,2784,3807,5221,1370,ITI,ITI3,11,Marche
2021-03-20,VEN,12944,5340,7604,10849,2095,ITH,ITH3,5,Veneto
2020-12-29,SAR,57,32,25,57,0,ITG,ITG2,20,Sardegna
2021-05-25,CAM,45952,21931,24021,22885,23067,ITF,ITF3,15,Campania
2021-03-27,PIE,18384,7827,10557,9553,8831,ITC,ITC1,1,Piemonte
2021-04-05,CAL,3501,1648,1853,2602,899,ITF,ITF6,18,Calabria
2021-04-22,SAR,10489,4646,5843,5570,4919,ITG,ITG2,20,Sardegna
2021-01-10,VEN,5032,1671,3361,5032,0,ITH,ITH3,5,Veneto
2021-03-21,ABR,2135,914,1221,844,1291,ITF,ITF1,13,Abruzzo
2021-01-05,LAZ,7374,2802,4572,7374,0,ITI,ITI4,12,Lazio
2021-02-17,LOM,11974,3747,8227,10584,1390,ITC,ITC4,3,Lombardia
2021-04-29,FVG,6695,2937,3758,4163,2532,ITH,ITH4,6,Friuli-Venezia Giulia
2021-03-27,PAT,1615,709,906,1362,253,ITH,ITH2,4,Provincia Autonoma Trento
2021-05-07,PUG,49405,22031,27374,26154,23251,ITF,ITF4,16,Puglia
2021-03-18,LIG,4981,2124,2857,2008,2973,ITC,ITC3,7,Liguria
2021-03-21,BAS,1046,481,565,352,694,ITF,ITF5,17,Basilicata
2021-04-01,LIG,12374,5467,6907,9604,2770,ITC,ITC3,7,Liguria
2021-05-23,VEN,34455,16448,18007,11068,23387,ITH,ITH3,5,Veneto
2021-05-29,BAS,3012,1511,1501,831,2181,ITF,ITF5,17,Basilicata
2021-05-19,PAB,3575,1820,1755,1812,1763,ITH,ITH1,4,Provincia Autonoma Bolzano / Bozen
2021-05-05,MOL,2413,1042,1371,2272,141,ITF,ITF2,14,Molise
2021-01-20,PAB,617,252,365,409,208,ITH,ITH1,4,Provincia Autonoma Bolzano / Bozen
2021-03-22,LOM,40304,14291,26013,29761,10543,ITC,ITC4,3,Lombardia
2021-03-03,SAR,3859,2073,1786,2611,1248,ITG,ITG2,20,Sardegna
2021-05-25,CAL,16332,7967,8365,10250,6082,ITF,ITF6,18,Calabria
2021-04-22,LOM,73780,33333,40447,57485,16295,ITC,ITC4,3,Lombardia
2021-02-24,FVG,2520,1084,1436,2502,18,ITH,ITH4,6,Friuli-Venezia Giulia
2021-02-05,PAT,802,272,530,283,519,ITH,ITH2,4,Provincia Autonoma Trento
2021-04-22,CAL,9620,4795,4825,6778,2842,ITF,ITF6,18,Calabria
2021-01-05,PAT,709,232,477,709,0,ITH,ITH2,4,Provincia Autonoma Trento
2021-02-15,PUG,3252,1268,1984,2632,620,ITF,ITF4,16,Puglia
2021-01-17,TOS,2536,871,1665,2023,513,ITI,ITI1,9,Toscana
2021-03-11,PAB,1681,823,858,1143,538,ITH,ITH1,4,Provincia Autonoma Bolzano / Bozen
2021-03-10,PIE,13635,5169,8466,11341,2294,ITC,ITC1,1,Piemonte
2021-04-15,FVG,6487,2859,3628,5216,1271,ITH,ITH4,6,Friuli-Venezia Giulia
2021-02-07,LAZ,4942,2023,2919,387,4555,ITI,ITI4,12,Lazio
2021-05-30,TOS,28623,13929,14694,21703,6920,ITI,ITI1,9,Toscana
2021-04-22,CAM,33941,16530,17411,21539,12402,ITF,ITF3,15,Campania
2021-04-06,PUG,13581,6027,7554,6831,6750,ITF,ITF4,16,Puglia
2021-05-14,MAR,13492,6217,7275,6720,6772,ITI,ITI3,11,Marche
2021-01-31,SAR,2121,750,1371,48,2073,ITG,ITG2,20,Sardegna
2021-01-19,PIE,6466,2105,4361,6454,12,ITC,ITC1,1,Piemonte
2021-02-14,SAR,539,263,276,537,2,ITG,ITG2,20,Sardegna
2021-04-23,VDA,921,443,478,538,383,ITC,ITC2,2,Valle d'Aosta / Vallée d'Aoste
2021-04-05,LOM,27383,11697,15686,19273,8110,ITC,ITC4,3,Lombardia
2021-01-13,BAS,916,387,529,916,0,ITF,ITF5,17,Basilicata
2021-01-19,PAT,405,77,328,405,0,ITH,ITH2,4,Provincia Autonoma Trento
2021-05-22,UMB,6909,2712,4197,2640,4269,ITI,ITI2,10,Umbria
2021-01-09,CAL,1924,1040,884,1924,0,ITF,ITF6,18,Calabria
2021-04-05,SAR,2036,784,1252,2035,1,ITG,ITG2,20,Sardegna
2021-01-31,LOM,9731,3760,5971,29,9702,ITC,ITC4,3,Lombardia
2021-02-22,PAB,526,143,383,514,12,ITH,ITH1,4,Provincia Autonoma Bolzano / Bozen
2021-05-25,LOM,90761,43429,47332,44584,46177,ITC,ITC4,3,Lombardia
2021-03-04,VDA,291,139,152,42,249,ITC,ITC2,2,Valle d'Aosta / Vallée d'Aoste
2021-03-10,PAT,2411,928,1483,1490,921,ITH,ITH2,4,Provincia Autonoma Trento
2021-02-23,EMR,8215,3219,4996,7829,386,ITH,ITH5,8,Emilia-Romagna
2021-04-20,PUG,21081,9784,11297,17627,3454,ITF,ITF4,16,Puglia
2021-05-28,ABR,13960,6276,7684,7612,6348,ITF,ITF1,13,Abruzzo
2021-01-09,CAM,10567,5024,5543,10567,0,ITF,ITF3,15,Campania
2021-04-19,UMB,5015,2216,2799,2966,2049,ITI,ITI2,10,Umbria
2021-01-03,PAB,41,16,25,41,0,ITH,ITH1,4,Provincia Autonoma Bolzano / Bozen
2021-01-13,ABR,1253,440,813,1253,0,ITF,ITF1,13,Abruzzo
2021-06-03,PAT,3377,1587,1790,811,2566,ITH,ITH2,4,Provincia Autonoma Trento
2021-05-03,LAZ,39103,17639,21464,26532,12571,ITI,ITI4,12,Lazio
2021-05-07,VDA,564,245,319,533,31,ITC,ITC2,2,Valle d'Aosta / Vallée d'Aoste
2021-05-04,MOL,2704,1181,1523,2576,128,ITF,ITF2,14,Molise
2021-01-10,MOL,270,72,198,270,0,ITF,ITF2,14,Molise
2021-04-06,VDA,741,381,360,629,112,ITC,ITC2,2,Valle d'Aosta / Vallée d'Aoste
2021-04-14,PIE,27703,12559,15144,23182,4521,ITC,ITC1,1,Piemonte
2020-12-31,TOS,804,202,602,804,0,ITI,ITI1,9,Toscana
2021-01-30,BAS,704,227,477,128,576,ITF,ITF5,17,Basilicata
2021-04-19,VDA,751,325,426,542,209,ITC,ITC2,2,Valle d'Aosta / Vallée d'Aoste
2021-01-13,TOS,4062,1398,2664,4062,0,ITI,ITI1,9,Toscana
2021-04-01,PIE,19330,8073,11257,11210,8120,ITC,ITC1,1,Piemonte
2021-01-08,EMR,10865,3580,7285,10865,0,ITH,ITH5,8,Emilia-Romagna
2021-01-06,MAR,2181,792,1389,2181,0,ITI,ITI3,11,Marche
2021-03-06,LIG,3304,1842,1462,2599,705,ITC,ITC3,7,Liguria
2021-05-04,LOM,86764,41050,45714,72400,14364,ITC,ITC4,3,Lombardia
2021-01-31,CAL,1109,555,554,154,955,ITF,ITF6,18,Calabria
2021-02-19,FVG,3251,1289,1962,2824,427,ITH,ITH4,6,Friuli-Venezia Giulia
2021-02-11,ABR,816,262,554,773,43,ITF,ITF1,13,Abruzzo
2021-05-20,EMR,39837,18127,21710,18742,21095,ITH,ITH5,8,Emilia-Romagna
2021-05-30,PIE,27697,13184,14513,18373,9324,ITC,ITC1,1,Piemonte
2021-01-22,TOS,2866,1064,1802,528,2338,ITI,ITI1,9,Toscana
2021-05-13,CAM,55381,24808,30573,39389,15992,ITF,ITF3,15,Campania
2021-03-16,PAB,1290,532,758,124,1166,ITH,ITH1,4,Provincia Autonoma Bolzano / Bozen
2021-01-10,SAR,2183,750,1433,2183,0,ITG,ITG2,20,Sardegna
2021-02-17,PAT,1110,425,685,1020,90,ITH,ITH2,4,Provincia Autonoma Trento
2021-03-03,UMB,4438,1773,2665,3727,711,ITI,ITI2,10,Umbria
2021-05-24,ABR,12171,5783,6388,8875,3296,ITF,ITF1,13,Abruzzo
2021-02-11,BAS,951,401,550,868,83,ITF,ITF5,17,Basilicata
2021-01-17,LAZ,4894,2028,2866,4682,212,ITI,ITI4,12,Lazio
2021-04-24,FVG,6674,2945,3729,5432,1242,ITH,ITH4,6,Friuli-Venezia Giulia
2021-05-19,PUG,25613,12143,13470,19318,6295,ITF,ITF4,16,Puglia
2021-01-31,CAM,8067,3711,4356,23,8044,ITF,ITF3,15,Campania
2021-05-09,LIG,2825,1245,1580,1115,1710,ITC,ITC3,7,Liguria
2021-03-17,EMR,13720,5693,8027,5875,7845,ITH,ITH5,8,Emilia-Romagna
2021-04-29,LAZ,38569,17214,21355,25345,13224,ITI,ITI4,12,Lazio
2021-02-25,MOL,541,239,302,473,68,ITF,ITF2,14,Molise
2021-04-27,SAR,7606,3547,4059,5565,2041,ITG,ITG2,20,Sardegna
2021-01-15,VEN,5874,1819,4055,5874,0,ITH,ITH3,5,Veneto
2021-02-24,SIC,9561,4850,4711,8971,590,ITG,ITG1,19,Sicilia
2021-02-17,PIE,4793,2156,2637,3803,990,ITC,ITC1,1,Piemonte
2021-03-15,SAR,2688,1219,1469,2315,373,ITG,ITG2,20,Sardegna
2021-03-01,LOM,18783,8228,10555,17078,1705,ITC,ITC4,3,Lombardia
2021-01-22,LIG,1817,604,1213,1331,486,ITC,ITC3,7,Liguria
2021-01-16,VDA,236,80,156,236,0,ITC,ITC2,2,Valle d'Aosta / Vallée d'Aoste
2021-05-04,CAM,48450,23336,25114,39562,8888,ITF,ITF3,15,Campania
2021-05-01,UMB,5374,2640,2734,2146,3228,ITI,ITI2,10,Umbria
2021-03-15,VEN,16601,7266,9335,11384,5217,ITH,ITH3,5,Veneto
2021-05-09,MAR,8769,3985,4784,3638,5131,ITI,ITI3,11,Marche
2021-05-14,PAB,5102,2297,2805,3086,2016,ITH,ITH1,4,Provincia Autonoma Bolzano / Bozen
2021-05-04,LIG,13601,6079,7522,5374,8227,ITC,ITC3,7,Liguria
2021-04-29,SIC,31687,14765,16922,22327,9360,ITG,ITG1,19,Sicilia
2021-02-01,PAB,1452,440,1012,12,1440,ITH,ITH1,4,Provincia Autonoma Bolzano / Bozen
2021-03-26,BAS,1957,703,1254,1696,261,ITF,ITF5,17,Basilicata
2021-05-18,VEN,26673,12425,14248,13236,13437,ITH,ITH3,5,Veneto
2021-05-30,PAT,1769,871,898,927,842,ITH,ITH2,4,Provincia Autonoma Trento
2021-05-29,ABR,10179,4411,5768,4544,5635,ITF,ITF1,13,Abruzzo
2021-03-27,TOS,8860,4150,4710,8645,215,ITI,ITI1,9,Toscana
2021-03-06,MAR,5700,2623,3077,4433,1267,ITI,ITI3,11,Marche
2021-04-30,MOL,2935,1554,1381,829,2106,ITF,ITF2,14,Molise
2021-03-25,PUG,10917,5299,5618,4682,6235,ITF,ITF4,16,Puglia
2021-03-26,ABR,5305,2263,3042,3231,2074,ITF,ITF1,13,Abruzzo
2021-04-20,ABR,5589,2689,2900,4179,1410,ITF,ITF1,13,Abruzzo
2021-01-26,LAZ,7958,3125,4833,724,7234,ITI,ITI4,12,Lazio
2021-02-26,PAT,1218,435,783,923,295,ITH,ITH2,4,Provincia Autonoma Trento
2021-05-25,TOS,33814,16216,17598,19336,14478,ITI,ITI1,9,Toscana
2020-12-28,CAL,6,2,4,6,0,ITF,ITF6,18,Calabria
2021-01-19,SAR,747,270,477,692,55,ITG,ITG2,20,Sardegna
2021-02-10,PUG,3644,1436,2208,2134,1510,ITF,ITF4,16,Puglia
2021-04-25,ABR,9066,4621,4445,8256,810,ITF,ITF1,13,Abruzzo
2021-05-19,VDA,993,498,495,418,575,ITC,ITC2,2,Valle d'Aosta / Vallée d'Aoste
2021-05-08,LAZ,45177,20615,24562,29815,15362,ITI,ITI4,12,Lazio
2021-01-28,UMB,1247,394,853,19,1228,ITI,ITI2,10,Umbria
2021-05-13,LOM,86947,41686,45261,58231,28716,ITC,ITC4,3,Lombardia
2021-05-09,MOL,2051,932,1119,1955,96,ITF,ITF2,14,Molise
2021-05-23,PUG,17731,8295,9436,13930,3801,ITF,ITF4,16,Puglia
2021-06-02,BAS,5951,2796,3155,4414,1537,ITF,ITF5,17,Basilicata
2021-05-03,FVG,7180,3270,3910,3406,3774,ITH,ITH4,6,Friuli-Venezia Giulia
2021-05-08,SIC,35762,17078,18684,25435,10327,ITG,ITG1,19,Sicilia
2021-05-28,PUG,41670,19408,22262,26807,14863,ITF,ITF4,16,Puglia
2021-02-20,BAS,1161,531,630,1043,118,ITF,ITF5,17,Basilicata
2021-02-26,PIE,12293,4933,7360,11556,737,ITC,ITC1,1,Piemonte
2021-03-24,SAR,7287,2998,4289,5928,1359,ITG,ITG2,20,Sardegna
2021-01-26,SIC,9483,4669,4814,259,9224,ITG,ITG1,19,Sicilia
2021-01-08,ABR,1525,507,1018,1525,0,ITF,ITF1,13,Abruzzo
2021-03-10,LOM,33239,12711,20528,25380,7859,ITC,ITC4,3,Lombardia
2021-02-28,FVG,2685,1002,1683,2292,393,ITH,ITH4,6,Friuli-Venezia Giulia
2021-03-16,VDA,180,37,143,118,62,ITC,ITC2,2,Valle d'Aosta / Vallée d'Aoste
2021-04-09,CAL,7933,3714,4219,5009,2924,ITF,ITF6,18,Calabria
2021-03-24,VEN,22020,9504,12516,15212,6808,ITH,ITH3,5,Veneto
2021-03-22,TOS,4890,2451,2439,4446,444,ITI,ITI1,9,Toscana
2021-03-06,MOL,1728,807,921,1569,159,ITF,ITF2,14,Molise
2021-01-21,SIC,1394,682,712,500,894,ITG,ITG1,19,Sicilia
2021-05-22,SAR,24298,11625,12673,19367,4931,ITG,ITG2,20,Sardegna
2021-05-23,PAB,4332,2302,2030,4324,8,ITH,ITH1,4,Provincia Autonoma Bolzano / Bozen
2021-02-09,VEN,5246,1889,3357,3446,1800,ITH,ITH3,5,Veneto
2021-05-10,UMB,5982,2799,3183,3830,2152,ITI,ITI2,10,Umbria
2021-01-14,PAT,700,203,497,700,0,ITH,ITH2,4,Provincia Autonoma Trento
2021-04-26,PIE,19756,8731,11025,15357,4399,ITC,ITC1,1,Piemonte
2021-06-03,CAL,8862,4077,4785,5553,3309,ITF,ITF6,18,Calabria
2021-05-24,BAS,4825,2340,2485,1103,3722,ITF,ITF5,17,Basilicata
2021-05-18,MAR,11061,5257,5804,7657,3404,ITI,ITI3,11,Marche
2021-02-10,PAB,1635,604,1031,26,1609,ITH,ITH1,4,Provincia Autonoma Bolzano / Bozen
2021-03-31,CAM,22685,10906,11779,19246,3439,ITF,ITF3,15,Campania
2021-04-26,PAT,2648,1246,1402,2554,94,ITH,ITH2,4,Provincia Autonoma Trento
2021-03-26,SIC,18036,8377,9659,12505,5531,ITG,ITG1,19,Sicilia
2021-04-30,PAB,3337,1592,1745,1562,1775,ITH,ITH1,4,Provincia Autonoma Bolzano / Bozen
2021-04-23,ABR,7369,3382,3987,5067,2302,ITF,ITF1,13,Abruzzo
2021-01-08,LIG,2926,999,1927,2926,0,ITC,ITC3,7,Liguria
2021-02-14,CAL,462,210,252,432,30,ITF,ITF6,18,Calabria
2021-03-01,VEN,9394,3716,5678,7572,1822,ITH,ITH3,5,Veneto
2021-05-16,PIE,28111,12762,15349,15055,13056,ITC,ITC1,1,Piemonte
2021-05-10,BAS,4807,2384,2423,2767,2040,ITF,ITF5,17,Basilicata
2021-03-17,CAM,11588,5099,6489,5008,6580,ITF,ITF3,15,Campania
2021-04-27,TOS,10347,4910,5437,3866,6481,ITI,ITI1,9,Toscana
2021-04-11,MAR,7116,3115,4001,6830,286,ITI,ITI3,11,Marche
2021-03-10,FVG,3358,1493,1865,1566,1792,ITH,ITH4,6,Friuli-Venezia Giulia
2021-05-01,EMR,28380,12764,15616,15611,12769,ITH,ITH5,8,Emilia-Romagna
2021-05-16,PAT,1321,729,592,1083,238,ITH,ITH2,4,Provincia Autonoma Trento
2021-03-03,CAM,13921,5494,8427,7291,6630,ITF,ITF3,15,Campania
2021-04-16,PAB,2949,1418,1531,2438,511,ITH,ITH1,4,Provincia Autonoma Bolzano / Bozen
2021-02-27,LIG,1888,921,967,1759,129,ITC,ITC3,7,Liguria
2021-03-15,LAZ,19276,8332,10944,12537,6739,ITI,ITI4,12,Lazio
2021-04-15,PAT,3182,1437,1745,3028,154,ITH,ITH2,4,Provincia Autonoma Trento
2021-03-16,MOL,614,230,384,267,347,ITF,ITF2,14,Molise
2021-05-26,PUG,37229,17475,19754,26111,11118,ITF,ITF4,16,Puglia
2021-04-08,SAR,13426,5924,7502,8307,5119,ITG,ITG2,20,Sardegna
2021-01-11,MOL,557,194,363,557,0,ITF,ITF2,14,Molise
2021-02-25,PAB,1498,549,949,1497,1,ITH,ITH1,4,Provincia Autonoma Bolzano / Bozen
2021-05-28,LOM,92862,44523,48339,42771,50091,ITC,ITC4,3,Lombardia
2021-03-15,SIC,10819,4718,6101,5754,5065,ITG,ITG1,19,Sicilia
2021-02-20,MAR,4121,1705,2416,4010,111,ITI,ITI3,11,Marche
2021-01-24,LAZ,5694,2229,3465,612,5082,ITI,ITI4,12,Lazio
2021-01-05,FVG,1678,551,1127,1678,0,ITH,ITH4,6,Friuli-Venezia Giulia
2021-05-18,LAZ,44136,20123,24013,34810,9326,ITI,ITI4,12,Lazio
2021-01-13,PUG,4540,1730,2810,4540,0,ITF,ITF4,16,Puglia
2021-01-12,CAM,5214,2563,2651,5214,0,ITF,ITF3,15,Campania
2021-03-19,VDA,322,85,237,286,36,ITC,ITC2,2,Valle d'Aosta / Vallée d'Aoste
2021-05-11,SAR,8648,3989,4659,6317,2331,ITG,ITG2,20,Sardegna
2021-03-17,CAL,3979,1769,2210,2138,1841,ITF,ITF6,18,Calabria
2021-01-29,VEN,9019,2788,6231,367,8652,ITH,ITH3,5,Veneto
2021-05-06,CAM,57258,27893,29365,42818,14440,ITF,ITF3,15,Campania
2021-05-10,ABR,10112,4785,5327,5460,4652,ITF,ITF1,13,Abruzzo
2021-04-29,PIE,48286,21842,26444,35668,12618,ITC,ITC1,1,Piemonte
2021-05-25,SAR,13676,6680,6996,8344,5332,ITG,ITG2,20,Sardegna
2021-01-24,SIC,4307,2251,2056,140,4167,ITG,ITG1,19,Sicilia
2020-12-29,LOM,104,44,60,104,0,ITC,ITC4,3,Lombardia
2021-04-29,PAT,4621,2232,2389,4412,209,ITH,ITH2,4,Provincia Autonoma Trento
2021-03-03,LOM,26978,11513,15465,19699,7279,ITC,ITC4,3,Lombardia
2021-03-18,PUG,9401,4254,5147,3284,6117,ITF,ITF4,16,Puglia
2021-03-29,LAZ,23960,10760,13200,16923,7037,ITI,ITI4,12,Lazio
2021-03-30,PAB,1298,532,766,218,1080,ITH,ITH1,4,Provincia Autonoma Bolzano / Bozen
2021-04-03,VEN,21943,9627,12316,14226,7717,ITH,ITH3,5,Veneto
2021-03-27,FVG,4985,2560,2425,3574,1411,ITH,ITH4,6,Friuli-Venezia Giulia
2021-03-22,SAR,3551,1363,2188,3038,513,ITG,ITG2,20,Sardegna
2021-05-06,CAL,13251,6269,6982,8992,4259,ITF,ITF6,18,Calabria
2021-03-25,MAR,6656,2772,3884,3247,3409,ITI,ITI3,11,Marche
2021-02-10,LIG,2314,837,1477,1019,1295,ITC,ITC3,7,Liguria
2021-05-11,LOM,86730,41373,45357,60608,26122,ITC,ITC4,3,Lombardia
2021-06-02,PAB,1442,809,633,987,455,ITH,ITH1,4,Provincia Autonoma Bolzano / Bozen
2021-01-12,SAR,865,408,457,865,0,ITG,ITG2,20,Sardegna
2021-02-05,EMR,9316,2966,6350,1637,7679,ITH,ITH5,8,Emilia-Romagna
2021-03-08,TOS,6371,2630,3741,1551,4820,ITI,ITI1,9,Toscana
2021-01-27,PUG,4580,1931,2649,611,3969,ITF,ITF4,16,Puglia
2021-02-08,PAB,2,1,1,1,1,ITH,ITH1,4,Provincia Autonoma Bolzano / Bozen
2021-01-20,MAR,403,100,303,384,19,ITI,ITI3,11,Marche
2021-02-12,VEN,4314,1447,2867,3742,572,ITH,ITH3,5,Veneto
2021-02-03,MAR,2124,741,1383,119,2005,ITI,ITI3,11,Marche
2021-01-25,MOL,319,130,189,3,316,ITF,ITF2,14,Molise
2021-02-05,FVG,2614,785,1829,90,2524,ITH,ITH4,6,Friuli-Venezia Giulia
2021-02-24,PAT,1318,523,795,922,396,ITH,ITH2,4,Provincia Autonoma Trento
2021-04-14,FVG,7216,3119,4097,5504,1712,ITH,ITH4,6,Friuli-Venezia Giulia
2021-04-13,PAB,2391,1130,1261,2384,7,ITH,ITH1,4,Provincia Autonoma Bolzano / Bozen
2021-04-20,MOL,2318,1025,1293,1220,1098,ITF,ITF2,14,Molise
2021-04-10,TOS,11722,5348,6374,10977,745,ITI,ITI1,9,Toscana
2021-04-14,EMR,27006,12825,14181,20902,6104,ITH,ITH5,8,Emilia-Romagna
2021-03-01,PUG,15090,5862,9228,13720,1370,ITF,ITF4,16,Puglia
2021-02-28,CAM,10412,3206,7206,8512,1900,ITF,ITF3,15,Campania
2021-06-03,FVG,4819,2471,2348,4393,426,ITH,ITH4,6,Friuli-Venezia Giulia
2021-05-06,LIG,14465,6404,8061,6165,8300,ITC,ITC3,7,Liguria
2021-01-12,LOM,20217,6697,13520,20217,0,ITC,ITC4,3,Lombardia
2021-02-19,TOS,8291,2952,5339,7781,510,ITI,ITI1,9,Toscana
2021-01-10,PUG,2348,1061,1287,2348,0,ITF,ITF4,16,Puglia
2020-12-27,PUG,509,252,257,509,0,ITF,ITF4,16,Puglia
2021-04-19,SIC,18475,8737,9738,12768,5707,ITG,ITG1,19,Sicilia
2021-03-17,LIG,5552,2368,3184,2473,3079,ITC,ITC3,7,Liguria
2021-05-08,VEN,41186,18630,22556,29397,11789,ITH,ITH3,5,Veneto
2021-01-13,VDA,337,110,227,337,0,ITC,ITC2,2,Valle d'Aosta / Vallée d'Aoste
2021-05-23,MOL,1698,863,835,1693,5,ITF,ITF2,14,Molise
2021-04-23,BAS,4537,2186,2351,3537,1000,ITF,ITF5,17,Basilicata
2021-02-13,ABR,849,383,466,437,412,ITF,ITF1,13,Abruzzo
2021-04-19,CAL,7838,3781,4057,6174,1664,ITF,ITF6,18,Calabria
2021-05-22,SIC,48110,22846,25264,28673,19437,ITG,ITG1,19,Sicilia
2021-02-11,UMB,842,349,493,837,5,ITI,ITI2,10,Umbria
2021-03-18,VDA,136,43,93,99,37,ITC,ITC2,2,Valle d'Aosta / Vallée d'Aoste
2021-02-14,CAM,3928,1923,2005,3894,34,ITF,ITF3,15,Campania
2021-02-14,LOM,3577,1545,2032,2942,635,ITC,ITC4,3,Lombardia
2021-05-26,VDA,1209,587,622,576,633,ITC,ITC2,2,Valle d'Aosta / Vallée d'Aoste
2021-04-29,MAR,13246,6061,7185,7149,6097,ITI,ITI3,11,Marche
2021-04-03,MOL,1770,850,920,1735,35,ITF,ITF2,14,Molise
2021-01-19,FVG,6,2,4,6,0,ITH,ITH4,6,Friuli-Venezia Giulia
2021-06-03,EMR,21450,10488,10962,17653,3797,ITH,ITH5,8,Emilia-Romagna
2021-04-19,CAM,30730,14817,15913,19163,11567,ITF,ITF3,15,Campania
2021-02-06,MAR,2461,901,1560,522,1939,ITI,ITI3,11,Marche
2021-02-10,LOM,14392,4503,9889,7573,6819,ITC,ITC4,3,Lombardia
2021-01-03,TOS,3335,1051,2284,3335,0,ITI,ITI1,9,Toscana
2021-05-25,UMB,8753,4258,4495,7735,1018,ITI,ITI2,10,Umbria
2021-05-22,VDA,940,494,446,540,400,ITC,ITC2,2,Valle d'Aosta / Vallée d'Aoste
2020-12-27,VEN,880,395,485,880,0,ITH,ITH3,5,Veneto
2021-01-12,CAL,2063,1020,1043,2063,0,ITF,ITF6,18,Calabria
2021-01-06,PUG,3946,1669,2277,3946,0,ITF,ITF4,16,Puglia
2021-02-15,TOS,8771,3375,5396,7946,825,ITI,ITI1,9,Toscana
2021-02-26,EMR,7866,2996,4870,6821,1045,ITH,ITH5,8,Emilia-Romagna
2021-03-22,UMB,3559,1654,1905,2313,1246,ITI,ITI2,10,Umbria
2021-02-22,TOS,9818,4254,5564,9541,277,ITI,ITI1,9,Toscana
2021-05-19,MOL,2335,1205,1130,1912,423,ITF,ITF2,14,Molise
2021-05-13,FVG,11005,5287,5718,9006,1999,ITH,ITH4,6,Friuli-Venezia Giulia
2021-05-28,LIG,15970,7904,8066,11536,4434,ITC,ITC3,7,Liguria
2021-04-15,LIG,11817,5218,6599,9965,1852,ITC,ITC3,7,Liguria
2021-05-18,SIC,36148,17310,18838,23567,12581,ITG,ITG1,19,Sicilia
2021-02-24,CAM,11786,4149,7637,11098,688,ITF,ITF3,15,Campania
2021-06-01,LAZ,46836,22190,24646,29556,17280,ITI,ITI4,12,Lazio
2021-04-05,LAZ,19769,8992,10777,13591,6178,ITI,ITI4,12,Lazio
2021-02-12,EMR,5321,1679,3642,3918,1403,ITH,ITH5,8,Emilia-Romagna
2021-04-10,EMR,20906,9291,11615,16763,4143,ITH,ITH5,8,Emilia-Romagna
2021-04-17,EMR,27027,12931,14096,17731,9296,ITH,ITH5,8,Emilia-Romagna
2021-04-09,VDA,237,111,126,204,33,ITC,ITC2,2,Valle d'Aosta / Vallée d'Aoste
2021-03-30,MOL,2003,857,1146,1491,512,ITF,ITF2,14,Molise
2021-01-02,BAS,949,380,569,949,0,ITF,ITF5,17,Basilicata
2021-02-01,MOL,562,201,361,14,548,ITF,ITF2,14,Molise
2021-04-26,BAS,4464,2164,2300,4244,220,ITF,ITF5,17,Basilicata
2021-02-24,CAL,1848,942,906,1373,475,ITF,ITF6,18,Calabria
2021-03-29,SIC,15017,7037,7980,10501,4516,ITG,ITG1,19,Sicilia
2021-04-15,CAM,34338,16659,17679,24440,9898,ITF,ITF3,15,Campania
2021-05-30,EMR,26808,12653,14155,13244,13564,ITH,ITH5,8,Emilia-Romagna
2021-03-07,ABR,2520,629,1891,2520,0,ITF,ITF1,13,Abruzzo
2021-05-28,MAR,13954,6734,7220,9094,4860,ITI,ITI3,11,Marche
2021-05-29,VDA,798,434,364,561,237,ITC,ITC2,2,Valle d'Aosta / Vallée d'Aoste
2021-04-06,MOL,1494,701,793,1151,343,ITF,ITF2,14,Molise
2021-02-07,UMB,54,17,37,1,53,ITI,ITI2,10,Umbria
2021-06-01,SIC,38165,17231,20934,24507,13658,ITG,ITG1,19,Sicilia
2021-03-03,CAL,5001,2731,2270,3929,1072,ITF,ITF6,18,Calabria
2021-04-05,SIC,8024,3959,4065,6584,1440,ITG,ITG1,19,Sicilia
2021-02-21,BAS,284,113,171,284,0,ITF,ITF5,17,Basilicata
2021-03-07,BAS,887,309,578,849,38,ITF,ITF5,17,Basilicata
2021-04-24,VEN,24731,10817,13914,15652,9079,ITH,ITH3,5,Veneto
2021-03-03,LIG,4580,1847,2733,3554,1026,ITC,ITC3,7,Liguria
2021-04-12,SAR,6990,3179,3811,5276,1714,ITG,ITG2,20,Sardegna
2021-05-20,PAT,4998,2353,2645,3373,1625,ITH,ITH2,4,Provincia Autonoma Trento
2021-04-19,LAZ,30061,13661,16400,19383,10678,ITI,ITI4,12,Lazio
2021-02-25,VDA,201,101,100,194,7,ITC,ITC2,2,Valle d'Aosta / Vallée d'Aoste
2021-06-01,LOM,93286,45855,47431,76618,16668,ITC,ITC4,3,Lombardia
2021-05-03,CAL,14736,6753,7983,10536,4200,ITF,ITF6,18,Calabria
2021-03-17,PAT,2067,790,1277,1199,868,ITH,ITH2,4,Provincia Autonoma Trento
2021-02-15,MOL,144,70,74,141,3,ITF,ITF2,14,Molise
2021-05-10,CAM,35404,16371,19033,25487,9917,ITF,ITF3,15,Campania
2021-03-21,CAL,4454,1925,2529,2729,1725,ITF,ITF6,18,Calabria
2021-04-08,MAR,7522,3285,4237,7195,327,ITI,ITI3,11,Marche
2021-02-14,SIC,1058,403,655,918,140,ITG,ITG1,19,Sicilia
2021-01-27,ABR,1364,515,849,39,1325,ITF,ITF1,13,Abruzzo
2021-03-07,CAL,3330,1701,1629,3241,89,ITF,ITF6,18,Calabria
2021-04-24,TOS,13435,6164,7271,5991,7444,ITI,ITI1,9,Toscana
2021-04-17,VEN,22404,9078,13326,15122,7282,ITH,ITH3,5,Veneto
2021-02-24,LIG,3763,1560,2203,3505,258,ITC,ITC3,7,Liguria
2021-04-20,PAB,1560,783,777,1559,1,ITH,ITH1,4,Provincia Autonoma Bolzano / Bozen
2020-12-29,LIG,125,33,92,125,0,ITC,ITC3,7,Liguria
2021-06-01,SAR,13659,6340,7319,9507,4152,ITG,ITG2,20,Sardegna
2021-02-09,FVG,1842,555,1287,1556,286,ITH,ITH4,6,Friuli-Venezia Giulia
2021-01-06,VDA,65,33,32,65,0,ITC,ITC2,2,Valle d'Aosta / Vallée d'Aoste
2021-05-14,BAS,5906,2797,3109,3374,2532,ITF,ITF5,17,Basilicata
2021-02-14,LAZ,5773,2370,3403,5303,470,ITI,ITI4,12,Lazio
2021-03-05,VEN,13286,4978,8308,9625,3661,ITH,ITH3,5,Veneto
2021-05-20,PIE,38279,17703,20576,13556,24723,ITC,ITC1,1,Piemonte
2021-01-02,LAZ,6707,2631,4076,6707,0,ITI,ITI4,12,Lazio
2021-05-04,PUG,34795,14677,20118,18393,16402,ITF,ITF4,16,Puglia
2021-03-07,CAM,11911,5344,6567,8068,3843,ITF,ITF3,15,Campania
2021-05-03,CAM,40748,19886,20862,28902,11846,ITF,ITF3,15,Campania
2021-04-15,MAR,10376,4674,5702,9811,565,ITI,ITI3,11,Marche
2021-05-10,CAL,13132,6093,7039,7734,5398,ITF,ITF6,18,Calabria
2021-05-06,PAT,5505,2726,2779,4726,779,ITH,ITH2,4,Provincia Autonoma Trento
2021-05-14,ABR,10602,5076,5526,5443,5159,ITF,ITF1,13,Abruzzo
2021-04-01,ABR,5522,2442,3080,3435,2087,ITF,ITF1,13,Abruzzo
2021-03-01,PAB,922,221,701,921,1,ITH,ITH1,4,Provincia Autonoma Bolzano / Bozen
2021-02-02,PIE,10241,3509,6732,816,9425,ITC,ITC1,1,Piemonte
2021-02-28,SAR,368,169,199,142,226,ITG,ITG2,20,Sardegna
2021-02-24,MAR,3486,1515,1971,3408,78,ITI,ITI3,11,Marche
2021-03-22,PUG,9350,4555,4795,3705,5645,ITF,ITF4,16,Puglia
2021-01-17,PAB,2328,1044,1284,2317,11,ITH,ITH1,4,Provincia Autonoma Bolzano / Bozen
2021-02-16,PIE,3967,1756,2211,3209,758,ITC,ITC1,1,Piemonte
2021-01-02,LOM,199,72,127,199,0,ITC,ITC4,3,Lombardia
2021-03-15,PUG,11785,5626,6159,5284,6501,ITF,ITF4,16,Puglia
2021-02-28,LOM,7889,3257,4632,7674,215,ITC,ITC4,3,Lombardia
2021-01-17,PUG,1308,590,718,1239,69,ITF,ITF4,16,Puglia
2021-03-24,FVG,3766,1530,2236,2286,1480,ITH,ITH4,6,Friuli-Venezia Giulia
2021-03-12,TOS,16521,6220,10301,12993,3528,ITI,ITI1,9,Toscana
2021-01-02,SIC,4885,2541,2344,4885,0,ITG,ITG1,19,Sicilia
2021-01-26,FVG,1977,647,1330,217,1760,ITH,ITH4,6,Friuli-Venezia Giulia
2021-01-12,LIG,2459,885,1574,2459,0,ITC,ITC3,7,Liguria
2021-01-21,VEN,2293,719,1574,21,2272,ITH,ITH3,5,Veneto
2021-02-02,PAT,907,240,667,190,717,ITH,ITH2,4,Provincia Autonoma Trento
2021-05-09,PAT,2322,1210,1112,1978,344,ITH,ITH2,4,Provincia Autonoma Trento
2021-04-13,CAM,26599,12682,13917,21069,5530,ITF,ITF3,15,Campania
2021-05-05,MAR,11647,5299,6348,5218,6429,ITI,ITI3,11,Marche
2021-04-08,LAZ,26651,12174,14477,18969,7682,ITI,ITI4,12,Lazio
2021-04-13,LOM,47566,21235,26331,33496,14070,ITC,ITC4,3,Lombardia
2021-04-09,MOL,2318,1248,1070,2127,191,ITF,ITF2,14,Molise
2021-05-28,EMR,40592,18638,21954,17774,22818,ITH,ITH5,8,Emilia-Romagna
2021-05-21,TOS,28599,13226,15373,17445,11154,ITI,ITI1,9,Toscana
2021-04-27,VEN,28110,12747,15363,21194,6916,ITH,ITH3,5,Veneto
2021-01-18,MOL,114,48,66,114,0,ITF,ITF2,14,Molise
2021-02-05,UMB,780,234,546,18,762,ITI,ITI2,10,Umbria
2021-01-12,EMR,9475,3124,6351,9475,0,ITH,ITH5,8,Emilia-Romagna
2021-01-10,PIE,5214,2275,2939,5214,0,ITC,ITC1,1,Piemonte
2021-01-04,BAS,607,271,336,607,0,ITF,ITF5,17,Basilicata
2021-01-22,LOM,3103,865,2238,3034,69,ITC,ITC4,3,Lombardia
2021-01-12,FVG,2260,713,1547,2260,0,ITH,ITH4,6,Friuli-Venezia Giulia
2021-03-01,TOS,4472,1733,2739,832,3640,ITI,ITI1,9,Toscana
2021-02-06,PUG,4546,1928,2618,1590,2956,ITF,ITF4,16,Puglia
2021-02-22,VEN,7013,3040,3973,6626,387,ITH,ITH3,5,Veneto
2021-02-13,MAR,1063,453,610,1011,52,ITI,ITI3,11,Marche
2021-01-01,LIG,144,55,89,144,0,ITC,ITC3,7,Liguria
2021-01-04,ABR,1401,575,826,1401,0,ITF,ITF1,13,Abruzzo
2021-03-10,CAL,6552,3314,3238,5273,1279,ITF,ITF6,18,Calabria
2021-04-22,PIE,27628,12711,14917,20931,6697,ITC,ITC1,1,Piemonte
2021-04-10,UMB,7467,3512,3955,7332,135,ITI,ITI2,10,Umbria
2021-04-23,PAB,4542,2151,2391,3251,1291,ITH,ITH1,4,Provincia Autonoma Bolzano / Bozen
2021-01-10,PAT,84,19,65,84,0,ITH,ITH2,4,Provincia Autonoma Trento
2021-04-13,LIG,13076,5866,7210,11052,2024,ITC,ITC3,7,Liguria
2021-01-17,SIC,1302,589,713,1245,57,ITG,ITG1,19,Sicilia
2021-04-16,ABR,7535,3488,4047,5618,1917,ITF,ITF1,13,Abruzzo
2021-03-22,LAZ,21704,9067,12637,15041,6663,ITI,ITI4,12,Lazio
2021-05-13,CAL,15870,7612,8258,11211,4659,ITF,ITF6,18,Calabria
2021-04-24,EMR,28573,13213,15360,14360,14213,ITH,ITH5,8,Emilia-Romagna
2021-01-11,PAB,1570,513,1057,1570,0,ITH,ITH1,4,Provincia Autonoma Bolzano / Bozen
2021-05-15,VDA,1065,614,451,380,685,ITC,ITC2,2,Valle d'Aosta / Vallée d'Aoste
2021-03-27,LOM,32439,12373,20066,23720,8719,ITC,ITC4,3,Lombardia
2021-04-18,MAR,8820,4131,4689,7899,921,ITI,ITI3,11,Marche
2021-03-10,CAM,15253,7382,7871,8419,6834,ITF,ITF3,15,Campania
2021-03-22,SIC,16818,7916,8902,11275,5543,ITG,ITG1,19,Sicilia
2021-01-21,BAS,30,10,20,30,0,ITF,ITF5,17,Basilicata
2021-01-29,FVG,2414,814,1600,264,2150,ITH,ITH4,6,Friuli-Venezia Giulia
2021-01-20,PUG,1545,540,1005,1537,8,ITF,ITF4,16,Puglia
2021-02-05,VEN,8373,2535,5838,1415,6958,ITH,ITH3,5,Veneto
2021-02-23,VDA,216,123,93,216,0,ITC,ITC2,2,Valle d'Aosta / Vallée d'Aoste
2021-01-19,UMB,103,23,80,103,0,ITI,ITI2,10,Umbria
2021-01-27,MAR,2118,780,1338,122,1996,ITI,ITI3,11,Marche
2021-05-18,SAR,13752,6640,7112,9291,4461,ITG,ITG2,20,Sardegna
2021-03-24,UMB,4073,1760,2313,2750,1323,ITI,ITI2,10,Umbria
2021-05-03,ABR,11108,5240,5868,7259,3849,ITF,ITF1,13,Abruzzo
2021-05-02,PUG,21254,9640,11614,14004,7250,ITF,ITF4,16,Puglia
2021-03-27,LIG,3920,1537,2383,2524,1396,ITC,ITC3,7,Liguria
2021-01-05,LOM,7821,2567,5254,7821,0,ITC,ITC4,3,Lombardia
2021-03-27,CAM,21278,10032,11246,17414,3864,ITF,ITF3,15,Campania
2021-05-03,BAS,4514,2044,2470,3687,827,ITF,ITF5,17,Basilicata
2021-05-11,EMR,35224,16516,18708,27969,7255,ITH,ITH5,8,Emilia-Romagna
2021-05-30,CAL,10924,5242,5682,6773,4151,ITF,ITF6,18,Calabria
2021-04-28,VDA,1218,632,586,715,503,ITC,ITC2,2,Valle d'Aosta / Vallée d'Aoste
2021-04-03,FVG,3982,1968,2014,2654,1328,ITH,ITH4,6,Friuli-Venezia Giulia
2021-04-06,PAB,2249,1117,1132,2146,103,ITH,ITH1,4,Provincia Autonoma Bolzano / Bozen
2021-04-22,PAT,3146,1468,1678,3102,44,ITH,ITH2,4,Provincia Autonoma Trento
2021-05-04,TOS,18301,8207,10094,12854,5447,ITI,ITI1,9,Toscana
2021-03-05,SIC,15873,6835,9038,11556,4317,ITG,ITG1,19,Sicilia
2021-06-02,ABR,9685,4692,4993,6875,2810,ITF,ITF1,13,Abruzzo
2021-03-21,EMR,11920,5273,6647,7316,4604,ITH,ITH5,8,Emilia-Romagna
2021-04-13,MOL,1630,718,912,1043,587,ITF,ITF2,14,Molise
2021-05-30,LIG,3275,1603,1672,1364,1911,ITC,ITC3,7,Liguria
2021-03-13,ABR,4125,1421,2704,3082,1043,ITF,ITF1,13,Abruzzo
2021-05-17,CAL,15071,7531,7540,10358,4713,ITF,ITF6,18,Calabria
2021-02-12,TOS,7606,2683,4923,7393,213,ITI,ITI1,9,Toscana
2021-01-02,UMB,304,111,193,304,0,ITI,ITI2,10,Umbria
2021-01-03,PUG,2007,943,1064,2007,0,ITF,ITF4,16,Puglia
2021-01-10,MAR,1737,699,1038,1737,0,ITI,ITI3,11,Marche
2021-05-01,SAR,9902,4759,5143,5445,4457,ITG,ITG2,20,Sardegna
2021-04-05,PIE,14746,6233,8513,12189,2557,ITC,ITC1,1,Piemonte
2021-01-19,VEN,1309,472,837,1159,150,ITH,ITH3,5,Veneto
2021-02-06,VDA,289,104,185,92,197,ITC,ITC2,2,Valle d'Aosta / Vallée d'Aoste
2021-03-07,UMB,845,180,665,838,7,ITI,ITI2,10,Umbria
2021-02-04,CAL,3557,1694,1863,652,2905,ITF,ITF6,18,Calabria
2021-04-15,PUG,32382,15106,17276,28883,3499,ITF,ITF4,16,Puglia
2021-04-07,FVG,7499,3324,4175,6718,781,ITH,ITH4,6,Friuli-Venezia Giulia
2020-12-31,SIC,880,470,410,880,0,ITG,ITG1,19,Sicilia
2021-06-03,CAM,44864,21572,23292,37928,6936,ITF,ITF3,15,Campania
2021-05-01,VEN,38765,18199,20566,29849,8916,ITH,ITH3,5,Veneto
2021-04-17,TOS,20533,9206,11327,18411,2122,ITI,ITI1,9,Toscana
2021-02-26,SAR,2800,1108,1692,2494,306,ITG,ITG2,20,Sardegna
2021-03-30,BAS,2739,1156,1583,2394,345,ITF,ITF5,17,Basilicata
2021-03-05,LAZ,18793,7962,10831,14060,4733,ITI,ITI4,12,Lazio
2021-04-05,PAT,35,17,18,33,2,ITH,ITH2,4,Provincia Autonoma Trento
2021-04-11,VDA,479,208,271,479,0,ITC,ITC2,2,Valle d'Aosta / Vallée d'Aoste
2021-05-13,LIG,13023,5848,7175,8810,4213,ITC,ITC3,7,Liguria
2021-05-29,LAZ,51223,22843,28380,40863,10360,ITI,ITI4,12,Lazio
2021-02-16,SIC,4370,2282,2088,3905,465,ITG,ITG1,19,Sicilia
2021-01-02,VEN,5743,1766,3977,5743,0,ITH,ITH3,5,Veneto
2021-03-27,MOL,2743,1273,1470,1310,1433,ITF,ITF2,14,Molise
2021-04-14,SAR,8250,3902,4348,7013,1237,ITG,ITG2,20,Sardegna
2021-02-21,CAL,609,286,323,532,77,ITF,ITF6,18,Calabria
2021-03-19,PIE,11019,4511,6508,4414,6605,ITC,ITC1,1,Piemonte
2021-01-29,UMB,1232,348,884,79,1153,ITI,ITI2,10,Umbria
2021-02-08,CAL,1849,735,1114,662,1187,ITF,ITF6,18,Calabria
2021-06-01,EMR,26571,12749,13822,16993,9578,ITH,ITH5,8,Emilia-Romagna
2021-01-24,FVG,305,119,186,1,304,ITH,ITH4,6,Friuli-Venezia Giulia
2021-05-26,MAR,11803,5916,5887,8620,3183,ITI,ITI3,11,Marche
2021-04-06,LIG,13171,5857,7314,10931,2240,ITC,ITC3,7,Liguria
2021-05-31,PAB,2987,1464,1523,2120,867,ITH,ITH1,4,Provincia Autonoma Bolzano / Bozen
2021-02-08,LIG,1976,741,1235,306,1670,ITC,ITC3,7,Liguria
2021-02-17,VEN,6022,2772,3250,5928,94,ITH,ITH3,5,Veneto
2021-03-22,FVG,3540,1343,2197,1586,1954,ITH,ITH4,6,Friuli-Venezia Giulia
2021-03-30,MAR,7418,3044,4374,4603,2815,ITI,ITI3,11,Marche
2021-04-27,PAT,3880,1866,2014,3813,67,ITH,ITH2,4,Provincia Autonoma Trento
2021-02-05,SAR,1897,749,1148,433,1464,ITG,ITG2,20,Sardegna
2020-12-27,LIG,135,56,79,135,0,ITC,ITC3,7,Liguria
2021-04-01,VEN,25197,11052,14145,18786,6411,ITH,ITH3,5,Veneto
2021-02-01,MAR,1362,479,883,98,1264,ITI,ITI3,11,Marche
2021-03-08,PIE,13947,5294,8653,11233,2714,ITC,ITC1,1,Piemonte
2021-04-03,SAR,4663,1802,2861,2696,1967,ITG,ITG2,20,Sardegna
2021-02-05,SIC,7103,3158,3945,2128,4975,ITG,ITG1,19,Sicilia
2021-01-18,ABR,122,48,74,46,76,ITF,ITF1,13,Abruzzo
2021-05-04,PIE,28482,13076,15406,16396,12086,ITC,ITC1,1,Piemonte
2021-05-30,SAR,9725,4836,4889,7369,2356,ITG,ITG2,20,Sardegna
2021-04-15,VEN,20824,8596,12228,10019,10805,ITH,ITH3,5,Veneto
2021-05-12,ABR,9616,4586,5030,6046,3570,ITF,ITF1,13,Abruzzo
2021-04-03,SIC,16350,7780,8570,13514,2836,ITG,ITG1,19,Sicilia
2021-03-16,ABR,3484,1452,2032,1830,1654,ITF,ITF1,13,Abruzzo
2021-05-04,PAT,4475,2422,2053,4385,90,ITH,ITH2,4,Provincia Autonoma Trento
2021-04-12,EMR,19218,8993,10225,14776,4442,ITH,ITH5,8,Emilia-Romagna
2021-03-08,PAT,1398,433,965,1045,353,ITH,ITH2,4,Provincia Autonoma Trento
2021-03-23,MAR,5789,2529,3260,2262,3527,ITI,ITI3,11,Marche
2021-02-10,VEN,4751,1588,3163,3697,1054,ITH,ITH3,5,Veneto
2021-02-13,PAB,318,79,239,312,6,ITH,ITH1,4,Provincia Autonoma Bolzano / Bozen
2021-04-08,VEN,32320,14348,17972,24439,7881,ITH,ITH3,5,Veneto
2021-04-11,PAB,2720,1291,1429,2543,177,ITH,ITH1,4,Provincia Autonoma Bolzano / Bozen
2021-03-27,SAR,5719,2177,3542,5296,423,ITG,ITG2,20,Sardegna
2021-05-19,MAR,11470,5272,6198,8561,2909,ITI,ITI3,11,Marche
2021-05-23,SAR,9964,4805,5159,7720,2244,ITG,ITG2,20,Sardegna
2021-02-15,LIG,2262,839,1423,1865,397,ITC,ITC3,7,Liguria
2021-01-31,FVG,2714,836,1878,385,2329,ITH,ITH4,6,Friuli-Venezia Giulia
2021-05-24,PAB,1442,761,681,1109,333,ITH,ITH1,4,Provincia Autonoma Bolzano / Bozen
2021-05-05,ABR,11582,5546,6036,6451,5131,ITF,ITF1,13,Abruzzo
2021-04-27,PIE,22573,10205,12368,17436,5137,ITC,ITC1,1,Piemonte
2021-03-27,SIC,15750,7437,8313,10837,4913,ITG,ITG1,19,Sicilia
2021-03-09,ABR,5168,1795,3373,4229,939,ITF,ITF1,13,Abruzzo
2021-01-29,SIC,9355,4318,5037,425,8930,ITG,ITG1,19,Sicilia
2021-01-17,PIE,3518,1168,2350,2870,648,ITC,ITC1,1,Piemonte
2021-03-15,PIE,10658,4162,6496,5037,5621,ITC,ITC1,1,Piemonte
2021-05-11,PIE,31976,15401,16575,18836,13140,ITC,ITC1,1,Piemonte
2021-05-23,SIC,34146,16616,17530,20120,14026,ITG,ITG1,19,Sicilia
2021-05-04,FVG,9511,4286,5225,6158,3353,ITH,ITH4,6,Friuli-Venezia Giulia
2021-02-15,MAR,967,412,555,954,13,ITI,ITI3,11,Marche
2021-03-15,PAT,1410,545,865,946,464,ITH,ITH2,4,Provincia Autonoma Trento
2021-01-17,PAT,251,195,56,251,0,ITH,ITH2,4,Provincia Autonoma Trento
2021-03-08,FVG,4063,1593,2470,1978,2085,ITH,ITH4,6,Friuli-Venezia Giulia
2021-05-11,PAT,3694,1749,1945,2849,845,ITH,ITH2,4,Provincia Autonoma Trento
2021-04-28,ABR,9510,4585,4925,7486,2024,ITF,ITF1,13,Abruzzo
2021-01-24,PIE,3153,959,2194,434,2719,ITC,ITC1,1,Piemonte
2021-02-19,SAR,1499,473,1026,1443,56,ITG,ITG2,20,Sardegna
2021-01-01,PAB,6,5,1,6,0,ITH,ITH1,4,Provincia Autonoma Bolzano / Bozen
2021-03-22,PIE,11510,4880,6630,3904,7606,ITC,ITC1,1,Piemonte
2021-01-05,VEN,7329,2182,5147,7329,0,ITH,ITH3,5,Veneto
2021-02-27,PAB,2458,759,1699,2448,10,ITH,ITH1,4,Provincia Autonoma Bolzano / Bozen
2021-01-17,FVG,1716,523,1193,1716,0,ITH,ITH4,6,Friuli-Venezia Giulia
2021-04-06,MAR,8879,3693,5186,8066,813,ITI,ITI3,11,Marche
2021-03-15,FVG,3765,1636,2129,1446,2319,ITH,ITH4,6,Friuli-Venezia Giulia
2021-03-22,PAT,2306,973,1333,1431,875,ITH,ITH2,4,Provincia Autonoma Trento
2021-01-24,PAT,547,276,271,224,323,ITH,ITH2,4,Provincia Autonoma Trento
2021-02-08,MAR,833,258,575,371,462,ITI,ITI3,11,Marche
2021-05-11,FVG,8953,4290,4663,7165,1788,ITH,ITH4,6,Friuli-Venezia Giulia
2021-02-12,SAR,2237,933,1304,2178,59,ITG,ITG2,20,Sardegna
2021-01-03,LIG,734,230,504,734,0,ITC,ITC3,7,Liguria
2021-04-10,SAR,10489,4748,5741,8554,1935,ITG,ITG2,20,Sardegna
2021-02-20,PAB,1802,540,1262,1784,18,ITH,ITH1,4,Provincia Autonoma Bolzano / Bozen
2021-02-12,SIC,4674,1847,2827,4406,268,ITG,ITG1,19,Sicilia
2021-02-24,VEN,8614,3678,4936,8128,486,ITH,ITH3,5,Veneto
2021-04-18,PAB,3110,1607,1503,2100,1010,ITH,ITH1,4,Provincia Autonoma Bolzano / Bozen
2021-01-31,PIE,4113,1753,2360,112,4001,ITC,ITC1,1,Piemonte
2021-01-31,PAT,75,15,60,1,74,ITH,ITH2,4,Provincia Autonoma Trento
2021-01-09,EMR,9984,3450,6534,9984,0,ITH,ITH5,8,Emilia-Romagna
2021-03-07,EMR,6861,2640,4221,5344,1517,ITH,ITH5,8,Emilia-Romagna
2021-05-03,EMR,28454,13444,15010,17578,10876,ITH,ITH5,8,Emilia-Romagna
2021-01-15,PAB,3282,1228,2054,3282,0,ITH,ITH1,4,Provincia Autonoma Bolzano / Bozen
2021-01-07,SAR,3112,1077,2035,3112,0,ITG,ITG2,20,Sardegna
2021-02-07,PIE,3088,974,2114,445,2643,ITC,ITC1,1,Piemonte
2021-05-31,VDA,879,395,484,500,379,ITC,ITC2,2,Valle d'Aosta / Vallée d'Aoste
2021-06-03,LAZ,41755,20830,20925,29219,12536,ITI,ITI4,12,Lazio
2020-12-27,MAR,200,97,103,200,0,ITI,ITI3,11,Marche
2021-05-28,MOL,2465,1288,1177,1956,509,ITF,ITF2,14,Molise
2021-01-16,EMR,5626,1718,3908,5626,0,ITH,ITH5,8,Emilia-Romagna
2021-03-14,EMR,8696,3744,4952,4899,3797,ITH,ITH5,8,Emilia-Romagna
2021-01-08,PAB,1521,479,1042,1521,0,ITH,ITH1,4,Provincia Autonoma Bolzano / Bozen
2020-12-31,SAR,32,16,16,32,0,ITG,ITG2,20,Sardegna
2021-04-08,MOL,1766,903,863,1564,202,ITF,ITF2,14,Molise
2021-04-19,EMR,20882,9788,11094,14610,6272,ITH,ITH5,8,Emilia-Romagna
2021-04-21,LAZ,32977,14973,18004,20613,12364,ITI,ITI4,12,Lazio
2021-04-18,VDA,522,254,268,518,4,ITC,ITC2,2,Valle d'Aosta / Vallée d'Aoste
2021-04-22,MOL,1844,863,981,1065,779,ITF,ITF2,14,Molise
2021-05-24,MOL,1951,847,1104,1285,666,ITF,ITF2,14,Molise
2021-02-13,PUG,3726,1455,2271,3031,695,ITF,ITF4,16,Puglia
2021-03-20,LOM,32508,12148,20360,22657,9851,ITC,ITC4,3,Lombardia
2021-02-03,TOS,4221,1452,2769,241,3980,ITI,ITI1,9,Toscana
2021-01-19,EMR,2045,505,1540,2028,17,ITH,ITH5,8,Emilia-Romagna
2021-04-04,MOL,253,141,112,238,15,ITF,ITF2,14,Molise
2021-05-09,LOM,69516,32810,36706,56426,13090,ITC,ITC4,3,Lombardia
2021-02-12,CAM,6529,2861,3668,6343,186,ITF,ITF3,15,Campania
2021-01-29,LOM,13442,4114,9328,656,12786,ITC,ITC4,3,Lombardia
2021-05-06,UMB,9455,4311,5144,6148,3307,ITI,ITI2,10,Umbria
2021-03-25,TOS,23613,10123,13490,15274,8339,ITI,ITI1,9,Toscana
2021-02-27,MOL,1366,568,798,1347,19,ITF,ITF2,14,Molise
2021-03-17,UMB,3331,1313,2018,1859,1472,ITI,ITI2,10,Umbria
2021-02-13,MOL,132,80,52,132,0,ITF,ITF2,14,Molise
2021-02-16,BAS,905,377,528,807,98,ITF,ITF5,17,Basilicata
2021-02-12,CAL,1710,667,1043,945,765,ITF,ITF6,18,Calabria
2021-03-17,SIC,15170,7462,7708,9258,5912,ITG,ITG1,19,Sicilia
2021-04-03,CAM,21115,10315,10800,18735,2380,ITF,ITF3,15,Campania
2021-02-26,LAZ,13075,5700,7375,11713,1362,ITI,ITI4,12,Lazio
2021-02-24,EMR,9327,3558,5769,8443,884,ITH,ITH5,8,Emilia-Romagna
2021-04-21,VDA,868,410,458,620,248,ITC,ITC2,2,Valle d'Aosta / Vallée d'Aoste
2021-01-05,EMR,9362,3170,6192,9362,0,ITH,ITH5,8,Emilia-Romagna
2021-01-26,UMB,816,390,426,18,798,ITI,ITI2,10,Umbria
2021-04-18,MOL,1083,483,600,149,934,ITF,ITF2,14,Molise
2021-04-29,EMR,44897,21106,23791,27355,17542,ITH,ITH5,8,Emilia-Romagna
2021-05-23,LIG,2305,1119,1186,1182,1123,ITC,ITC3,7,Liguria
2021-04-03,CAL,8872,3808,5064,4282,4590,ITF,ITF6,18,Calabria
2021-01-28,ABR,1433,495,938,12,1421,ITF,ITF1,13,Abruzzo
2021-05-23,CAM,58716,28617,30099,37840,20876,ITF,ITF3,15,Campania
2021-05-06,SIC,29156,13834,15322,18455,10701,ITG,ITG1,19,Sicilia
2021-05-01,LAZ,37920,17069,20851,25970,11950,ITI,ITI4,12,Lazio
2021-04-07,BAS,1218,549,669,1181,37,ITF,ITF5,17,Basilicata
2021-04-17,LAZ,32307,14176,18131,20360,11947,ITI,ITI4,12,Lazio
2021-01-29,CAM,10052,4812,5240,47,10005,ITF,ITF3,15,Campania
2021-03-02,VDA,339,166,173,336,3,ITC,ITC2,2,Valle d'Aosta / Vallée d'Aoste
2021-05-09,PUG,30487,12487,18000,14930,15557,ITF,ITF4,16,Puglia
2021-01-28,CAL,2234,1108,1126,83,2151,ITF,ITF6,18,Calabria
2021-03-27,MAR,7379,3073,4306,5021,2358,ITI,ITI3,11,Marche
2021-03-19,CAM,11037,4870,6167,7165,3872,ITF,ITF3,15,Campania
2021-05-22,CAL,22043,10501,11542,14220,7823,ITF,ITF6,18,Calabria
2021-05-13,TOS,34859,15330,19529,13721,21138,ITI,ITI1,9,Toscana
2021-05-15,FVG,12593,6071,6522,7916,4677,ITH,ITH4,6,Friuli-Venezia Giulia
2021-03-31,SIC,14605,6750,7855,9577,5028,ITG,ITG1,19,Sicilia
2021-04-03,LIG,5404,2497,2907,4461,943,ITC,ITC3,7,Liguria
2021-04-29,TOS,39333,17708,21625,19237,20096,ITI,ITI1,9,Toscana
2021-01-21,FVG,896,345,551,1,895,ITH,ITH4,6,Friuli-Venezia Giulia
2021-03-12,LAZ,22901,10128,12773,16587,6314,ITI,ITI4,12,Lazio
2021-05-25,VEN,27222,13082,14140,11476,15746,ITH,ITH3,5,Veneto
2021-05-27,SAR,16258,8185,8073,11548,4710,ITG,ITG2,20,Sardegna
2021-05-01,PIE,28526,12993,15533,16728,11798,ITC,ITC1,1,Piemonte
2021-01-11,VDA,325,112,213,325,0,ITC,ITC2,2,Valle d'Aosta / Vallée d'Aoste
2021-04-02,CAL,8131,3706,4425,4336,3795,ITF,ITF6,18,Calabria
2021-04-06,BAS,1267,461,806,1082,185,ITF,ITF5,17,Basilicata
2021-01-29,PUG,6195,2661,3534,436,5759,ITF,ITF4,16,Puglia
2021-01-08,MOL,429,141,288,429,0,ITF,ITF2,14,Molise
2021-03-20,PUG,8255,3734,4521,3666,4589,ITF,ITF4,16,Puglia
2021-04-24,LOM,75672,33539,42133,54609,21063,ITC,ITC4,3,Lombardia
2021-05-16,MAR,10898,4957,5941,6670,4228,ITI,ITI3,11,Marche
2021-01-28,CAM,8832,4121,4711,134,8698,ITF,ITF3,15,Campania
2021-05-01,PAT,4837,2463,2374,4802,35,ITH,ITH2,4,Provincia Autonoma Trento
2021-03-26,FVG,5801,2425,3376,3789,2012,ITH,ITH4,6,Friuli-Venezia Giulia
2021-05-09,ABR,9152,4089,5063,4282,4870,ITF,ITF1,13,Abruzzo
2021-02-12,LIG,1927,689,1238,895,1032,ITC,ITC3,7,Liguria
2021-03-10,TOS,18014,7073,10941,13996,4018,ITI,ITI1,9,Toscana
2021-01-21,LAZ,5601,2348,3253,548,5053,ITI,ITI4,12,Lazio
2021-05-20,SIC,43541,20784,22757,27662,15879,ITG,ITG1,19,Sicilia
2021-04-05,VEN,19137,8367,10770,13697,5440,ITH,ITH3,5,Veneto
2021-02-01,BAS,242,91,151,46,196,ITF,ITF5,17,Basilicata
2021-01-07,LAZ,7747,2902,4845,7747,0,ITI,ITI4,12,Lazio
2021-05-26,BAS,4523,2280,2243,1759,2764,ITF,ITF5,17,Basilicata
2021-05-08,CAL,18273,8326,9947,10470,7803,ITF,ITF6,18,Calabria
2021-03-05,LOM,28976,11944,17032,20572,8404,ITC,ITC4,3,Lombardia
2021-04-10,MAR,10916,4620,6296,10603,313,ITI,ITI3,11,Marche
2021-03-12,PAT,2506,936,1570,1701,805,ITH,ITH2,4,Provincia Autonoma Trento
2021-05-12,BAS,4722,2324,2398,2839,1883,ITF,ITF5,17,Basilicata
2021-03-19,LOM,32412,12910,19502,19218,13194,ITC,ITC4,3,Lombardia
2021-05-01,FVG,7187,3244,3943,6144,1043,ITH,ITH4,6,Friuli-Venezia Giulia
2021-02-24,PAB,1367,406,961,1355,12,ITH,ITH1,4,Provincia Autonoma Bolzano / Bozen
2021-02-14,VEN,125,56,69,112,13,ITH,ITH3,5,Veneto
2021-03-24,TOS,19687,8004,11683,10230,9457,ITI,ITI1,9,Toscana
2021-02-16,SAR,700,289,411,673,27,ITG,ITG2,20,Sardegna
2021-02-12,PUG,4165,1660,2505,3073,1092,ITF,ITF4,16,Puglia
2021-01-21,PIE,6923,2318,4605,3427,3496,ITC,ITC1,1,Piemonte
2021-02-28,VEN,4136,1389,2747,3299,837,ITH,ITH3,5,Veneto
2021-05-15,PIE,33610,15674,17936,19975,13635,ITC,ITC1,1,Piemonte
2021-03-19,CAL,4187,1947,2240,1900,2287,ITF,ITF6,18,Calabria
2021-02-05,MAR,2155,653,1502,440,1715,ITI,ITI3,11,Marche
2021-05-08,CAM,56349,27099,29250,40528,15821,ITF,ITF3,15,Campania
2021-03-23,BAS,1582,608,974,1409,173,ITF,ITF5,17,Basilicata
2021-01-14,LOM,26798,7781,19017,26798,0,ITC,ITC4,3,Lombardia
2021-05-30,MAR,9732,4689,5043,6742,2990,ITI,ITI3,11,Marche
2021-01-21,PAT,352,95,257,228,124,ITH,ITH2,4,Provincia Autonoma Trento
2021-05-08,LOM,87367,40595,46772,65654,21713,ITC,ITC4,3,Lombardia
2021-02-09,SIC,4411,1823,2588,3356,1055,ITG,ITG1,19,Sicilia
2021-04-21,UMB,5310,2308,3002,3084,2226,ITI,ITI2,10,Umbria
2021-03-12,FVG,3938,1544,2394,2557,1381,ITH,ITH4,6,Friuli-Venezia Giulia
2021-04-15,PAB,4399,2307,2092,4136,263,ITH,ITH1,4,Provincia Autonoma Bolzano / Bozen
2021-05-21,EMR,37734,16827,20907,20952,16782,ITH,ITH5,8,Emilia-Romagna
2021-05-16,LAZ,50895,24506,26389,37421,13474,ITI,ITI4,12,Lazio
2021-05-20,VDA,807,363,444,367,440,ITC,ITC2,2,Valle d'Aosta / Vallée d'Aoste
2021-03-24,VDA,515,230,285,258,257,ITC,ITC2,2,Valle d'Aosta / Vallée d'Aoste
2021-05-17,MOL,2228,1092,1136,1732,496,ITF,ITF2,14,Molise
2021-03-21,MOL,1246,542,704,479,767,ITF,ITF2,14,Molise
2021-05-31,PUG,34892,16386,18506,22177,12715,ITF,ITF4,16,Puglia
2021-03-14,MOL,596,240,356,17,579,ITF,ITF2,14,Molise
2021-03-18,EMR,13673,5806,7867,5673,8000,ITH,ITH5,8,Emilia-Romagna
2021-05-14,EMR,36994,17040,19954,27427,9567,ITH,ITH5,8,Emilia-Romagna
2021-02-03,EMR,9355,2995,6360,984,8371,ITH,ITH5,8,Emilia-Romagna
2021-04-01,EMR,23880,10732,13148,19339,4541,ITH,ITH5,8,Emilia-Romagna
2021-02-26,ABR,3914,1670,2244,2946,968,ITF,ITF1,13,Abruzzo
2021-02-16,VDA,325,53,272,320,5,ITC,ITC2,2,Valle d'Aosta / Vallée d'Aoste
2021-04-28,BAS,4704,2158,2546,4263,441,ITF,ITF5,17,Basilicata
2021-02-12,LAZ,6844,2845,3999,6432,412,ITI,ITI4,12,Lazio
2021-04-24,CAL,18994,9476,9518,15585,3409,ITF,ITF6,18,Calabria
2021-04-17,CAM,36172,17506,18666,24666,11506,ITF,ITF3,15,Campania
2021-02-26,CAL,3062,1631,1431,2609,453,ITF,ITF6,18,Calabria
2021-03-28,MOL,1626,747,879,524,1102,ITF,ITF2,14,Molise
2021-04-11,PUG,16443,7240,9203,14787,1656,ITF,ITF4,16,Puglia
2021-01-30,MOL,461,158,303,12,449,ITF,ITF2,14,Molise
2021-03-02,BAS,794,383,411,659,135,ITF,ITF5,17,Basilicata
2021-02-19,CAM,9570,3559,6011,8920,650,ITF,ITF3,15,Campania
2021-05-28,TOS,29811,13701,16110,17478,12333,ITI,ITI1,9,Toscana
2021-04-10,LAZ,23812,10315,13497,16630,7182,ITI,ITI4,12,Lazio
2021-02-05,LAZ,7278,2960,4318,1183,6095,ITI,ITI4,12,Lazio
2021-04-07,VDA,910,474,436,681,229,ITC,ITC2,2,Valle d'Aosta / Vallée d'Aoste
2021-04-08,TOS,29655,12538,17117,23275,6380,ITI,ITI1,9,Toscana
2021-04-03,LAZ,24686,11093,13593,17987,6699,ITI,ITI4,12,Lazio
2021-02-09,VDA,251,84,167,68,183,ITC,ITC2,2,Valle d'Aosta / Vallée d'Aoste
2020-12-31,CAM,1490,811,679,1490,0,ITF,ITF3,15,Campania
2021-01-07,CAL,2186,1066,1120,2186,0,ITF,ITF6,18,Calabria
2021-02-26,CAM,13339,4230,9109,12004,1335,ITF,ITF3,15,Campania
2021-02-06,MOL,429,179,250,29,400,ITF,ITF2,14,Molise
2021-04-17,CAL,10844,5080,5764,9047,1797,ITF,ITF6,18,Calabria
2021-04-18,PUG,22538,10777,11761,21473,1065,ITF,ITF4,16,Puglia
2021-04-24,CAM,36328,17519,18809,25082,11246,ITF,ITF3,15,Campania
2021-05-01,CAL,16696,7962,8734,12433,4263,ITF,ITF6,18,Calabria
2021-02-20,PUG,2969,1080,1889,2713,256,ITF,ITF4,16,Puglia
2021-04-21,BAS,3921,1835,2086,2271,1650,ITF,ITF5,17,Basilicata
2021-03-05,CAL,6228,3612,2616,5655,573,ITF,ITF6,18,Calabria
2021-05-23,LOM,60727,28916,31811,26788,33939,ITC,ITC4,3,Lombardia
2021-04-15,TOS,24392,10192,14200,15865,8527,ITI,ITI1,9,Toscana
2021-04-25,PUG,11204,5197,6007,10047,1157,ITF,ITF4,16,Puglia
2021-02-17,TOS,8175,3169,5006,7423,752,ITI,ITI1,9,Toscana
2021-02-27,PUG,14212,4812,9400,12987,1225,ITF,ITF4,16,Puglia
2021-01-01,PUG,148,61,87,148,0,ITF,ITF4,16,Puglia
2021-05-30,CAM,51987,25342,26645,38808,13179,ITF,ITF3,15,Campania
2021-04-03,LOM,36240,14861,21379,26151,10089,ITC,ITC4,3,Lombardia
2020-12-31,LAZ,5293,2121,3172,5293,0,ITI,ITI4,12,Lazio
2021-05-30,LOM,74244,35533,38711,34313,39931,ITC,ITC4,3,Lombardia
2021-04-22,TOS,35721,15303,20418,18281,17440,ITI,ITI1,9,Toscana
2021-02-24,TOS,10372,4467,5905,10171,201,ITI,ITI1,9,Toscana
2021-05-20,UMB,9829,4585,5244,6192,3637,ITI,ITI2,10,Umbria
2021-03-06,PUG,15974,5968,10006,13887,2087,ITF,ITF4,16,Puglia
2021-01-08,PUG,5597,2347,3250,5597,0,ITF,ITF4,16,Puglia
2021-04-10,CAM,28341,13486,14855,23428,4913,ITF,ITF3,15,Campania
2021-02-12,LOM,13943,4356,9587,9023,4920,ITC,ITC4,3,Lombardia
2021-02-19,LAZ,10047,5081,4966,9216,831,ITI,ITI4,12,Lazio
2021-04-10,LOM,52389,21706,30683,40597,11792,ITC,ITC4,3,Lombardia
2021-03-03,TOS,18193,6509,11684,14587,3606,ITI,ITI1,9,Toscana
2021-01-05,TOS,5249,1755,3494,5249,0,ITI,ITI1,9,Toscana
2021-01-15,PUG,4552,1866,2686,4552,0,ITF,ITF4,16,Puglia
2021-03-31,UMB,3903,1733,2170,2216,1687,ITI,ITI2,10,Umbria
2021-05-27,SIC,47156,21528,25628,24888,22268,ITG,ITG1,19,Sicilia
2021-02-16,UMB,1308,655,653,1299,9,ITI,ITI2,10,Umbria
2021-05-27,UMB,9930,4828,5102,8647,1283,ITI,ITI2,10,Umbria
2021-04-14,UMB,8150,3673,4477,6171,1979,ITI,ITI2,10,Umbria
2021-05-29,FVG,11890,5781,6109,6980,4910,ITH,ITH4,6,Friuli-Venezia Giulia
2021-04-17,LIG,7383,3217,4166,6633,750,ITC,ITC3,7,Liguria
2021-02-19,LOM,14166,5387,8779,13486,680,ITC,ITC4,3,Lombardia
2021-04-17,LOM,48392,21259,27133,37624,10768,ITC,ITC4,3,Lombardia
2021-02-26,LOM,18360,7548,10812,16513,1847,ITC,ITC4,3,Lombardia
2021-01-22,PUG,1409,578,831,991,418,ITF,ITF4,16,Puglia
2021-01-25,BAS,1023,429,594,74,949,ITF,ITF5,17,Basilicata
2021-06-03,UMB,6541,3219,3322,6359,182,ITI,ITI2,10,Umbria
2021-04-07,UMB,5568,2289,3279,3562,2006,ITI,ITI2,10,Umbria
2021-01-12,TOS,3581,1398,2183,3581,0,ITI,ITI1,9,Toscana
2021-05-22,FVG,11508,5167,6341,7285,4223,ITH,ITH4,6,Friuli-Venezia Giulia
2020-12-31,LOM,714,301,413,714,0,ITC,ITC4,3,Lombardia
2021-01-07,LOM,11759,3635,8124,11759,0,ITC,ITC4,3,Lombardia
2021-01-18,BAS,463,157,306,364,99,ITF,ITF5,17,Basilicata
2021-03-16,BAS,1904,801,1103,229,1675,ITF,ITF5,17,Basilicata
2021-01-07,CAM,8910,4166,4744,8910,0,ITF,ITF3,15,Campania
2021-01-19,TOS,1104,531,573,1104,0,ITI,ITI1,9,Toscana
2021-03-12,CAL,5115,2452,2663,4045,1070,ITF,ITF6,18,Calabria
2021-04-14,SIC,20289,9798,10491,11505,8784,ITG,ITG1,19,Sicilia
2021-03-05,CAM,16483,6348,10135,9820,6663,ITF,ITF3,15,Campania
2021-01-04,UMB,810,398,412,810,0,ITI,ITI2,10,Umbria
2021-01-14,CAL,2635,1248,1387,2635,0,ITF,ITF6,18,Calabria
2021-01-07,LIG,3229,1095,2134,3229,0,ITC,ITC3,7,Liguria
2021-04-17,MAR,11699,5315,6384,10626,1073,ITI,ITI3,11,Marche
2021-05-01,LIG,7131,3253,3878,1332,5799,ITC,ITC3,7,Liguria
2021-03-05,LIG,4869,2150,2719,3737,1132,ITC,ITC3,7,Liguria
2021-04-26,VEN,20708,9450,11258,15567,5141,ITH,ITH3,5,Veneto
2021-05-05,BAS,4337,2050,2287,3447,890,ITF,ITF5,17,Basilicata
2021-05-27,TOS,27887,12812,15075,13249,14638,ITI,ITI1,9,Toscana
2021-05-11,MAR,10622,4832,5790,5678,4944,ITI,ITI3,11,Marche
2021-04-18,ABR,5811,2726,3085,4869,942,ITF,ITF1,13,Abruzzo
2021-02-18,BAS,1070,401,669,855,215,ITF,ITF5,17,Basilicata
2021-05-30,PUG,20522,9824,10698,15586,4936,ITF,ITF4,16,Puglia
2021-04-01,SAR,10101,4026,6075,7088,3013,ITG,ITG2,20,Sardegna
2021-03-06,PIE,13994,5211,8783,11205,2789,ITC,ITC1,1,Piemonte
2021-01-22,PIE,3867,1249,2618,2526,1341,ITC,ITC1,1,Piemonte
2020-12-27,TOS,620,267,353,620,0,ITI,ITI1,9,Toscana
2021-03-29,UMB,3844,1692,2152,2365,1479,ITI,ITI2,10,Umbria
2021-01-31,UMB,1058,276,782,25,1033,ITI,ITI2,10,Umbria
2021-01-07,EMR,10272,3406,6866,10272,0,ITH,ITH5,8,Emilia-Romagna
2021-01-05,CAM,7237,3637,3600,7237,0,ITF,ITF3,15,Campania
2021-02-18,PAB,1839,457,1382,1832,7,ITH,ITH1,4,Provincia Autonoma Bolzano / Bozen
2021-05-12,MOL,2847,1291,1556,2751,96,ITF,ITF2,14,Molise
2021-01-16,BAS,721,304,417,721,0,ITF,ITF5,17,Basilicata
2021-05-06,FVG,11864,5513,6351,7911,3953,ITH,ITH4,6,Friuli-Venezia Giulia
2021-02-10,SAR,1959,765,1194,1441,518,ITG,ITG2,20,Sardegna
2021-02-03,LOM,25535,7897,17638,1078,24457,ITC,ITC4,3,Lombardia
2021-04-01,LOM,42924,17214,25710,26737,16187,ITC,ITC4,3,Lombardia
2021-02-19,EMR,7327,3010,4317,6813,514,ITH,ITH5,8,Emilia-Romagna
2020-12-31,EMR,2213,779,1434,2213,0,ITH,ITH5,8,Emilia-Romagna
2021-05-18,UMB,7721,3341,4380,3883,3838,ITI,ITI2,10,Umbria
2020-12-30,PAB,388,182,206,388,0,ITH,ITH1,4,Provincia Autonoma Bolzano / Bozen
2021-03-17,FVG,3233,1266,1967,743,2490,ITH,ITH4,6,Friuli-Venezia Giulia
2021-01-15,PAT,595,132,463,595,0,ITH,ITH2,4,Provincia Autonoma Trento
2020-12-30,PUG,1,0,1,1,0,ITF,ITF4,16,Puglia
2021-01-05,CAL,1467,686,781,1467,0,ITF,ITF6,18,Calabria
2021-04-10,VEN,27444,11971,15473,18963,8481,ITH,ITH3,5,Veneto
2021-02-07,SIC,2338,991,1347,674,1664,ITG,ITG1,19,Sicilia
2021-01-16,ABR,929,429,500,929,0,ITF,ITF1,13,Abruzzo
2021-02-11,VDA,231,107,124,222,9,ITC,ITC2,2,Valle d'Aosta / Vallée d'Aoste
2021-05-21,MAR,12951,6113,6838,6695,6256,ITI,ITI3,11,Marche
2021-05-25,LAZ,46185,21187,24998,35427,10758,ITI,ITI4,12,Lazio
2021-05-26,MOL,1528,684,844,783,745,ITF,ITF2,14,Molise
2021-02-28,BAS,804,343,461,775,29,ITF,ITF5,17,Basilicata
2021-04-08,LIG,13723,6156,7567,11680,2043,ITC,ITC3,7,Liguria
2021-05-25,SIC,33156,15006,18150,13988,19168,ITG,ITG1,19,Sicilia
2021-05-30,VEN,22452,11227,11225,15816,6636,ITH,ITH3,5,Veneto
2021-02-17,CAM,7388,3210,4178,6328,1060,ITF,ITF3,15,Campania
2021-04-12,LAZ,23758,10677,13081,16861,6897,ITI,ITI4,12,Lazio
2021-04-03,EMR,19936,8766,11170,16196,3740,ITH,ITH5,8,Emilia-Romagna
2021-01-09,ABR,1483,565,918,1483,0,ITF,ITF1,13,Abruzzo
2021-04-16,VDA,599,261,338,597,2,ITC,ITC2,2,Valle d'Aosta / Vallée d'Aoste
2021-04-02,VDA,873,344,529,648,225,ITC,ITC2,2,Valle d'Aosta / Vallée d'Aoste
2021-04-01,MAR,7576,3182,4394,4160,3416,ITI,ITI3,11,Marche
2021-04-05,UMB,4250,1728,2522,2195,2055,ITI,ITI2,10,Umbria
2021-02-08,MOL,334,141,193,216,118,ITF,ITF2,14,Molise
2021-03-23,MOL,1642,694,948,1435,207,ITF,ITF2,14,Molise
2021-02-17,LIG,2688,1181,1507,2262,426,ITC,ITC3,7,Liguria
2021-01-09,BAS,557,160,397,557,0,ITF,ITF5,17,Basilicata
2021-01-05,LIG,2879,896,1983,2879,0,ITC,ITC3,7,Liguria
2021-02-26,VEN,8294,3271,5023,7036,1258,ITH,ITH3,5,Veneto
2021-02-16,FVG,2516,1135,1381,2400,116,ITH,ITH4,6,Friuli-Venezia Giulia
2021-05-13,PIE,35377,17286,18091,20518,14859,ITC,ITC1,1,Piemonte
2021-03-24,PAT,2376,940,1436,1556,820,ITH,ITH2,4,Provincia Autonoma Trento
2021-04-27,PAB,2226,1013,1213,1150,1076,ITH,ITH1,4,Provincia Autonoma Bolzano / Bozen
2021-05-27,PIE,36929,17100,19829,19046,17883,ITC,ITC1,1,Piemonte
2021-02-21,LAZ,6987,3179,3808,6525,462,ITI,ITI4,12,Lazio
2021-03-14,CAM,8501,3721,4780,4362,4139,ITF,ITF3,15,Campania
2021-04-27,PUG,26539,12012,14527,20954,5585,ITF,ITF4,16,Puglia
2021-05-07,BAS,4650,2284,2366,3295,1355,ITF,ITF5,17,Basilicata
2021-04-12,SIC,18954,9203,9751,11614,7340,ITG,ITG1,19,Sicilia
2021-03-25,ABR,5686,2561,3125,3070,2616,ITF,ITF1,13,Abruzzo
2021-04-28,EMR,33661,15551,18110,20775,12886,ITH,ITH5,8,Emilia-Romagna
2021-05-21,ABR,13004,6328,6676,8028,4976,ITF,ITF1,13,Abruzzo
2021-04-26,CAM,34001,16636,17365,28379,5622,ITF,ITF3,15,Campania
2021-03-18,ABR,3896,1651,2245,2065,1831,ITF,ITF1,13,Abruzzo
2021-04-22,LIG,13816,6194,7622,8746,5070,ITC,ITC3,7,Liguria
2021-04-19,SAR,10181,4617,5564,8762,1419,ITG,ITG2,20,Sardegna
2021-05-13,PAT,3406,1579,1827,2305,1101,ITH,ITH2,4,Provincia Autonoma Trento
2021-03-24,PIE,15505,6341,9164,6378,9127,ITC,ITC1,1,Piemonte
2021-02-28,LAZ,10248,4007,6241,9734,514,ITI,ITI4,12,Lazio
2021-02-18,VDA,349,153,196,261,88,ITC,ITC2,2,Valle d'Aosta / Vallée d'Aoste
2021-03-14,CAL,2703,1065,1638,2288,415,ITF,ITF6,18,Calabria
2021-02-22,MOL,265,129,136,250,15,ITF,ITF2,14,Molise
2021-03-08,PUG,14604,6087,8517,12205,2399,ITF,ITF4,16,Puglia
2020-12-27,MOL,50,20,30,50,0,ITF,ITF2,14,Molise
2021-03-18,BAS,1349,563,786,25,1324,ITF,ITF5,17,Basilicata
2021-01-26,PAT,542,154,388,27,515,ITH,ITH2,4,Provincia Autonoma Trento
2021-02-17,MAR,1785,662,1123,1668,117,ITI,ITI3,11,Marche
2021-02-21,SIC,5168,2501,2667,5062,106,ITG,ITG1,19,Sicilia
2021-01-09,LAZ,6296,2561,3735,6296,0,ITI,ITI4,12,Lazio
2021-05-07,ABR,12193,5702,6491,7764,4429,ITF,ITF1,13,Abruzzo
2021-03-15,PAB,1192,451,741,710,482,ITH,ITH1,4,Provincia Autonoma Bolzano / Bozen
2021-01-02,SAR,60,21,39,60,0,ITG,ITG2,20,Sardegna
2021-04-22,MAR,10795,4930,5865,9217,1578,ITI,ITI3,11,Marche
2021-03-31,PIE,19106,8102,11004,10413,8693,ITC,ITC1,1,Piemonte
2021-04-26,SAR,6820,3263,3557,5945,875,ITG,ITG2,20,Sardegna
2021-01-14,VEN,7062,1924,5138,7062,0,ITH,ITH3,5,Veneto
2021-01-24,PUG,1669,749,920,153,1516,ITF,ITF4,16,Puglia
2021-03-12,VEN,18572,8124,10448,11826,6746,ITH,ITH3,5,Veneto
2021-02-09,PAT,916,287,629,442,474,ITH,ITH2,4,Provincia Autonoma Trento
2021-04-26,LOM,87926,40919,47007,68770,19156,ITC,ITC4,3,Lombardia
2021-05-08,TOS,29141,13108,16033,13693,15448,ITI,ITI1,9,Toscana
2021-05-20,FVG,12410,6091,6319,9990,2420,ITH,ITH4,6,Friuli-Venezia Giulia
2021-01-14,TOS,3255,1179,2076,3255,0,ITI,ITI1,9,Toscana
2021-01-07,VEN,8358,2318,6040,8358,0,ITH,ITH3,5,Veneto
2021-01-10,PAB,2,2,0,2,0,ITH,ITH1,4,Provincia Autonoma Bolzano / Bozen
2021-02-21,SAR,1589,710,879,1559,30,ITG,ITG2,20,Sardegna
2021-03-03,MAR,6643,3046,3597,5761,882,ITI,ITI3,11,Marche
2021-01-05,MAR,1562,586,976,1562,0,ITI,ITI3,11,Marche
2021-04-25,CAL,15831,8032,7799,14694,1137,ITF,ITF6,18,Calabria
2021-01-03,UMB,270,112,158,270,0,ITI,ITI2,10,Umbria
2021-04-23,MAR,11159,5140,6019,8104,3055,ITI,ITI3,11,Marche
2021-05-21,PAT,5023,2410,2613,3325,1698,ITH,ITH2,4,Provincia Autonoma Trento
2021-01-08,LOM,12695,3915,8780,12695,0,ITC,ITC4,3,Lombardia
2021-02-27,VEN,8988,2691,6297,8141,847,ITH,ITH3,5,Veneto
2021-01-06,LIG,1660,616,1044,1660,0,ITC,ITC3,7,Liguria
2021-02-15,SIC,3926,1817,2109,3361,565,ITG,ITG1,19,Sicilia
2021-04-13,SAR,7606,3593,4013,5781,1825,ITG,ITG2,20,Sardegna
2021-03-11,TOS,15495,5993,9502,12169,3326,ITI,ITI1,9,Toscana
2021-01-03,SIC,4705,2461,2244,4705,0,ITG,ITG1,19,Sicilia
2021-03-10,BAS,1677,840,837,838,839,ITF,ITF5,17,Basilicata
2021-04-22,UMB,5427,2230,3197,2766,2661,ITI,ITI2,10,Umbria
2021-05-06,BAS,5054,2435,2619,3485,1569,ITF,ITF5,17,Basilicata
2021-02-03,PAT,846,314,532,414,432,ITH,ITH2,4,Provincia Autonoma Trento
2021-04-17,FVG,7447,3232,4215,5965,1482,ITH,ITH4,6,Friuli-Venezia Giulia
2021-01-10,SIC,3622,1616,2006,3622,0,ITG,ITG1,19,Sicilia
2021-01-26,EMR,8334,3000,5334,215,8119,ITH,ITH5,8,Emilia-Romagna
2021-04-09,ABR,8793,4140,4653,6254,2539,ITF,ITF1,13,Abruzzo
2021-05-23,PAT,1953,993,960,447,1506,ITH,ITH2,4,Provincia Autonoma Trento
2021-03-24,EMR,21082,9304,11778,13700,7382,ITH,ITH5,8,Emilia-Romagna
2021-01-15,LOM,25198,7428,17770,25198,0,ITC,ITC4,3,Lombardia
2021-01-18,PAB,1772,687,1085,1767,5,ITH,ITH1,4,Provincia Autonoma Bolzano / Bozen
2021-01-22,VEN,1080,332,748,25,1055,ITH,ITH3,5,Veneto
2021-03-08,SAR,4008,1790,2218,2788,1220,ITG,ITG2,20,Sardegna
2021-05-04,SAR,9537,4385,5152,7684,1853,ITG,ITG2,20,Sardegna
2021-02-10,PIE,7535,2371,5164,1316,6219,ITC,ITC1,1,Piemonte
2021-04-10,FVG,4986,2164,2822,3761,1225,ITH,ITH4,6,Friuli-Venezia Giulia
2021-04-15,SIC,21367,10387,10980,11810,9557,ITG,ITG1,19,Sicilia
2021-01-05,UMB,854,429,425,854,0,ITI,ITI2,10,Umbria
2021-04-08,PIE,25142,10929,14213,20412,4730,ITC,ITC1,1,Piemonte
2021-01-15,LIG,2255,754,1501,2255,0,ITC,ITC3,7,Liguria
2021-04-25,LIG,1936,921,1015,1521,415,ITC,ITC3,7,Liguria
2021-05-04,VEN,42790,20267,22523,34782,8008,ITH,ITH3,5,Veneto
2021-02-10,PAT,852,291,561,510,342,ITH,ITH2,4,Provincia Autonoma Trento
2021-01-13,MAR,2105,746,1359,2105,0,ITI,ITI3,11,Marche
2021-03-13,LIG,3827,1616,2211,2972,855,ITC,ITC3,7,Liguria
2021-05-05,PAB,4154,1945,2209,2038,2116,ITH,ITH1,4,Provincia Autonoma Bolzano / Bozen
2021-01-25,PAB,487,183,304,3,484,ITH,ITH1,4,Provincia Autonoma Bolzano / Bozen
2021-03-01,SAR,2162,1055,1107,1503,659,ITG,ITG2,20,Sardegna
2021-04-22,SIC,27157,12817,14340,20567,6590,ITG,ITG1,19,Sicilia
2021-01-12,UMB,838,248,590,838,0,ITI,ITI2,10,Umbria
2021-04-04,ABR,1631,768,863,1502,129,ITF,ITF1,13,Abruzzo
2021-04-08,PAT,3114,1294,1820,1996,1118,ITH,ITH2,4,Provincia Autonoma Trento
2021-04-15,PIE,29632,13572,16060,24150,5482,ITC,ITC1,1,Piemonte
2021-03-23,PAB,1552,759,793,1551,1,ITH,ITH1,4,Provincia Autonoma Bolzano / Bozen
2021-05-06,EMR,35459,16386,19073,22417,13042,ITH,ITH5,8,Emilia-Romagna
2021-01-15,MAR,1771,500,1271,1771,0,ITI,ITI3,11,Marche
2021-03-20,LIG,2316,995,1321,1142,1174,ITC,ITC3,7,Liguria
2021-05-11,VEN,32932,16416,16516,28244,4688,ITH,ITH3,5,Veneto
2021-04-10,PAT,2797,1307,1490,2003,794,ITH,ITH2,4,Provincia Autonoma Trento
2021-04-17,PIE,30427,14133,16294,27113,3314,ITC,ITC1,1,Piemonte
2021-02-02,BAS,367,143,224,175,192,ITF,ITF5,17,Basilicata
2021-04-02,ABR,6686,3094,3592,5199,1487,ITF,ITF1,13,Abruzzo
2021-04-25,MAR,8599,3993,4606,7024,1575,ITI,ITI3,11,Marche
2021-05-05,VDA,1038,566,472,456,582,ITC,ITC2,2,Valle d'Aosta / Vallée d'Aoste
2021-02-04,ABR,1679,615,1064,609,1070,ITF,ITF1,13,Abruzzo
2021-01-05,SIC,10539,5163,5376,10539,0,ITG,ITG1,19,Sicilia
2021-01-24,SAR,90,34,56,5,85,ITG,ITG2,20,Sardegna
2021-05-23,FVG,10260,4850,5410,6113,4147,ITH,ITH4,6,Friuli-Venezia Giulia
2021-04-25,MOL,792,395,397,559,233,ITF,ITF2,14,Molise
2021-05-02,MAR,8899,3936,4963,3161,5738,ITI,ITI3,11,Marche
2021-03-10,SAR,6011,2918,3093,5161,850,ITG,ITG2,20,Sardegna
2021-04-10,PIE,30163,13416,16747,25884,4279,ITC,ITC1,1,Piemonte
2021-05-06,SAR,12942,6007,6935,9797,3145,ITG,ITG2,20,Sardegna
2021-05-07,PAB,4181,2055,2126,3663,518,ITH,ITH1,4,Provincia Autonoma Bolzano / Bozen
2021-01-24,VEN,4117,1219,2898,28,4089,ITH,ITH3,5,Veneto
2021-03-10,SIC,13932,5954,7978,11547,2385,ITG,ITG1,19,Sicilia
2021-01-05,PIE,5381,1603,3778,5381,0,ITC,ITC1,1,Piemonte
2021-01-12,SIC,4548,2237,2311,4548,0,ITG,ITG1,19,Sicilia
2021-04-02,EMR,23304,10493,12811,18842,4462,ITH,ITH5,8,Emilia-Romagna
2021-05-29,EMR,37084,16188,20896,16731,20353,ITH,ITH5,8,Emilia-Romagna
2021-01-31,VEN,4769,1562,3207,392,4377,ITH,ITH3,5,Veneto
2021-03-29,VEN,31402,13634,17768,27568,3834,ITH,ITH3,5,Veneto
2021-04-01,PAB,2786,1407,1379,2642,144,ITH,ITH1,4,Provincia Autonoma Bolzano / Bozen
2020-12-31,PAT,1624,449,1175,1624,0,ITH,ITH2,4,Provincia Autonoma Trento
2021-05-13,SAR,11408,5284,6124,8428,2980,ITG,ITG2,20,Sardegna
2021-02-27,ABR,2810,1337,1473,2545,265,ITF,ITF1,13,Abruzzo
2021-01-07,PIE,5387,1739,3648,5387,0,ITC,ITC1,1,Piemonte
2021-03-05,PIE,15268,5961,9307,11451,3817,ITC,ITC1,1,Piemonte
2021-01-25,VDA,147,65,82,0,147,ITC,ITC2,2,Valle d'Aosta / Vallée d'Aoste
2021-05-22,CAM,67836,32440,35396,46440,21396,ITF,ITF3,15,Campania
2021-05-29,CAL,19014,8826,10188,9189,9825,ITF,ITF6,18,Calabria
2021-03-13,MOL,1189,594,595,200,989,ITF,ITF2,14,Molise
2021-01-15,MOL,538,242,296,538,0,ITF,ITF2,14,Molise
2021-03-05,PAT,2244,703,1541,1678,566,ITH,ITH2,4,Provincia Autonoma Trento
2021-03-25,PAB,2141,1059,1082,1698,443,ITH,ITH1,4,Provincia Autonoma Bolzano / Bozen
2021-03-20,MAR,4135,1740,2395,1049,3086,ITI,ITI3,11,Marche
2021-04-17,PAT,2203,1120,1083,2146,57,ITH,ITH2,4,Provincia Autonoma Trento
2021-01-26,SAR,1336,453,883,27,1309,ITG,ITG2,20,Sardegna
2020-12-31,PIE,3909,1334,2575,3909,0,ITC,ITC1,1,Piemonte
2021-01-27,PAB,84,28,56,1,83,ITH,ITH1,4,Provincia Autonoma Bolzano / Bozen
2021-01-22,MAR,487,167,320,194,293,ITI,ITI3,11,Marche
2021-05-15,LAZ,57058,27248,29810,40616,16442,ITI,ITI4,12,Lazio
2021-05-12,VDA,1138,549,589,468,670,ITC,ITC2,2,Valle d'Aosta / Vallée d'Aoste
2021-03-06,ABR,4177,1358,2819,3607,570,ITF,ITF1,13,Abruzzo
2021-03-19,LAZ,17215,7364,9851,10887,6328,ITI,ITI4,12,Lazio
2021-03-25,CAL,7386,3463,3923,4547,2839,ITF,ITF6,18,Calabria
2021-02-11,MAR,1987,657,1330,1598,389,ITI,ITI3,11,Marche
2021-02-21,VDA,18,3,15,0,18,ITC,ITC2,2,Valle d'Aosta / Vallée d'Aoste
2021-01-16,MOL,420,166,254,420,0,ITF,ITF2,14,Molise
2021-02-15,PAT,533,187,346,419,114,ITH,ITH2,4,Provincia Autonoma Trento
2021-01-15,SIC,5088,2236,2852,5088,0,ITG,ITG1,19,Sicilia
2021-01-20,LOM,5664,1378,4286,5550,114,ITC,ITC4,3,Lombardia
2021-03-28,ABR,2415,1017,1398,2044,371,ITF,ITF1,13,Abruzzo
2020-12-29,SIC,240,149,91,240,0,ITG,ITG1,19,Sicilia
2021-01-18,PUG,1845,770,1075,1496,349,ITF,ITF4,16,Puglia
2021-04-05,FVG,2868,1425,1443,2853,15,ITH,ITH4,6,Friuli-Venezia Giulia
2021-04-03,PIE,19430,8156,11274,10883,8547,ITC,ITC1,1,Piemonte
2021-02-03,VEN,5938,1664,4274,480,5458,ITH,ITH3,5,Veneto
2021-04-30,PUG,34664,15500,19164,22717,11947,ITF,ITF4,16,Puglia
2021-05-07,MAR,12838,5805,7033,3660,9178,ITI,ITI3,11,Marche
2021-03-25,LIG,9593,4080,5513,6200,3393,ITC,ITC3,7,Liguria
2021-05-16,VEN,28398,14001,14397,21319,7079,ITH,ITH3,5,Veneto
2021-04-05,EMR,14860,6809,8051,11969,2891,ITH,ITH5,8,Emilia-Romagna
2021-04-29,UMB,5209,2245,2964,2883,2326,ITI,ITI2,10,Umbria
2021-01-23,ABR,263,114,149,57,206,ITF,ITF1,13,Abruzzo
2021-03-29,CAM,18947,9134,9813,17401,1546,ITF,ITF3,15,Campania
2021-06-03,VDA,803,395,408,399,404,ITC,ITC2,2,Valle d'Aosta / Vallée d'Aoste
2021-01-30,PAB,498,245,253,4,494,ITH,ITH1,4,Provincia Autonoma Bolzano / Bozen
2021-02-24,SAR,2412,1293,1119,2223,189,ITG,ITG2,20,Sardegna
2021-01-29,PIE,5943,1886,4057,455,5488,ITC,ITC1,1,Piemonte
2021-06-01,CAL,12694,5867,6827,7832,4862,ITF,ITF6,18,Calabria
2021-01-17,UMB,54,17,37,54,0,ITI,ITI2,10,Umbria
2021-01-25,MAR,1596,559,1037,96,1500,ITI,ITI3,11,Marche
2021-04-15,LOM,49391,21838,27553,35582,13809,ITC,ITC4,3,Lombardia
2021-01-23,BAS,719,303,416,33,686,ITF,ITF5,17,Basilicata
2020-12-29,LAZ,488,176,312,488,0,ITI,ITI4,12,Lazio
2021-02-19,CAL,1508,681,827,1247,261,ITF,ITF6,18,Calabria
2021-01-29,PAT,1353,331,1022,55,1298,ITH,ITH2,4,Provincia Autonoma Trento
2021-06-01,CAM,41319,20321,20998,31232,10087,ITF,ITF3,15,Campania
2021-01-31,EMR,7696,2762,4934,241,7455,ITH,ITH5,8,Emilia-Romagna
2021-02-10,TOS,4263,1281,2982,3740,523,ITI,ITI1,9,Toscana
2021-01-03,LOM,854,316,538,854,0,ITC,ITC4,3,Lombardia
2021-04-22,EMR,29026,13433,15593,14952,14074,ITH,ITH5,8,Emilia-Romagna
2021-01-17,VEN,1933,781,1152,1584,349,ITH,ITH3,5,Veneto
2021-01-10,FVG,2939,918,2021,2939,0,ITH,ITH4,6,Friuli-Venezia Giulia
2021-04-11,MOL,1196,591,605,1182,14,ITF,ITF2,14,Molise
2021-04-14,BAS,2042,998,1044,1367,675,ITF,ITF5,17,Basilicata
2021-04-25,PAB,3072,1497,1575,2401,671,ITH,ITH1,4,Provincia Autonoma Bolzano / Bozen
2021-04-29,VEN,50208,23354,26854,37025,13183,ITH,ITH3,5,Veneto
2021-03-08,LIG,5629,2459,3170,3940,1689,ITC,ITC3,7,Liguria
2021-04-22,FVG,6768,3076,3692,3082,3686,ITH,ITH4,6,Friuli-Venezia Giulia
2021-04-14,ABR,6504,2898,3606,4424,2080,ITF,ITF1,13,Abruzzo
2021-04-12,UMB,7086,3076,4010,5369,1717,ITI,ITI2,10,Umbria
2021-04-13,PUG,28625,13566,15059,25228,3397,ITF,ITF4,16,Puglia
2021-01-13,PAB,1691,557,1134,1691,0,ITH,ITH1,4,Provincia Autonoma Bolzano / Bozen
2021-01-12,PIE,10089,3415,6674,10089,0,ITC,ITC1,1,Piemonte
2021-04-20,MAR,10697,4995,5702,9280,1417,ITI,ITI3,11,Marche
2021-05-17,VDA,809,417,392,375,434,ITC,ITC2,2,Valle d'Aosta / Vallée d'Aoste
2021-05-23,TOS,28368,13642,14726,25804,2564,ITI,ITI1,9,Toscana
2021-04-10,SIC,20662,10083,10579,11620,9042,ITG,ITG1,19,Sicilia
2020-12-31,UMB,322,127,195,322,0,ITI,ITI2,10,Umbria
2021-01-08,MAR,1576,588,988,1576,0,ITI,ITI3,11,Marche
2021-02-09,BAS,491,213,278,316,175,ITF,ITF5,17,Basilicata
2021-02-04,VDA,294,86,208,8,286,ITC,ITC2,2,Valle d'Aosta / Vallée d'Aoste
2021-05-15,CAM,62612,29036,33576,43946,18666,ITF,ITF3,15,Campania
2021-03-17,PIE,12518,5055,7463,5224,7294,ITC,ITC1,1,Piemonte
2021-03-24,LAZ,25876,11297,14579,19639,6237,ITI,ITI4,12,Lazio
2020-12-31,VEN,3220,1042,2178,3220,0,ITH,ITH3,5,Veneto
2021-03-25,MOL,1806,730,1076,1309,497,ITF,ITF2,14,Molise
2021-03-19,FVG,3234,1339,1895,1301,1933,ITH,ITH4,6,Friuli-Venezia Giulia
2021-04-12,VEN,14903,6335,8568,6684,8219,ITH,ITH3,5,Veneto
2021-03-26,UMB,4571,1683,2888,4399,172,ITI,ITI2,10,Umbria
2021-04-08,PAB,2754,1336,1418,2551,203,ITH,ITH1,4,Provincia Autonoma Bolzano / Bozen
2021-03-11,BAS,1790,924,866,831,959,ITF,ITF5,17,Basilicata
2021-03-02,EMR,11859,3906,7953,9830,2029,ITH,ITH5,8,Emilia-Romagna
2021-03-27,PUG,12139,5703,6436,6978,5161,ITF,ITF4,16,Puglia
2021-02-07,SAR,1117,395,722,228,889,ITG,ITG2,20,Sardegna
2021-04-28,CAL,12521,6060,6461,9663,2858,ITF,ITF6,18,Calabria
2021-04-30,VDA,831,355,476,485,346,ITC,ITC2,2,Valle d'Aosta / Vallée d'Aoste
2020-12-27,PAB,144,65,79,144,0,ITH,ITH1,4,Provincia Autonoma Bolzano / Bozen
2021-03-29,LOM,40017,15515,24502,25182,14835,ITC,ITC4,3,Lombardia
2021-05-06,TOS,31326,13612,17714,14171,17155,ITI,ITI1,9,Toscana
2021-02-23,CAM,11003,3388,7615,10477,526,ITF,ITF3,15,Campania
2021-05-20,SAR,15854,7500,8354,11305,4549,ITG,ITG2,20,Sardegna
2021-01-12,PAT,505,158,347,505,0,ITH,ITH2,4,Provincia Autonoma Trento
2021-01-16,CAL,2394,1120,1274,2394,0,ITF,ITF6,18,Calabria
2021-03-24,SIC,21146,9908,11238,15309,5837,ITG,ITG1,19,Sicilia
2021-05-27,LAZ,56218,25393,30825,43833,12385,ITI,ITI4,12,Lazio
2021-01-18,VDA,213,74,139,213,0,ITC,ITC2,2,Valle d'Aosta / Vallée d'Aoste
2021-01-06,BAS,294,129,165,294,0,ITF,ITF5,17,Basilicata
2021-01-24,TOS,3349,1073,2276,201,3148,ITI,ITI1,9,Toscana
2021-03-07,LAZ,14111,5442,8669,10518,3593,ITI,ITI4,12,Lazio
2021-02-28,PIE,10816,4060,6756,10576,240,ITC,ITC1,1,Piemonte
2021-03-11,ABR,5471,2198,3273,4332,1139,ITF,ITF1,13,Abruzzo
2021-03-08,MOL,1379,522,857,1239,140,ITF,ITF2,14,Molise
2021-04-07,PAT,2599,1012,1587,1658,941,ITH,ITH2,4,Provincia Autonoma Trento
2021-02-19,LIG,3213,1305,1908,3037,176,ITC,ITC3,7,Liguria
2021-03-28,BAS,2139,741,1398,2122,17,ITF,ITF5,17,Basilicata
2021-03-19,EMR,15843,6915,8928,7876,7967,ITH,ITH5,8,Emilia-Romagna
2021-01-21,SAR,126,60,66,94,32,ITG,ITG2,20,Sardegna
2021-06-01,LIG,15752,7870,7882,10542,5210,ITC,ITC3,7,Liguria
2021-03-12,CAM,14247,7096,7151,8165,6082,ITF,ITF3,15,Campania
2021-01-11,MAR,1176,411,765,1176,0,ITI,ITI3,11,Marche
2021-02-22,CAL,2032,1029,1003,1475,557,ITF,ITF6,18,Calabria
2021-06-02,CAL,7656,3695,3961,5777,1879,ITF,ITF6,18,Calabria
2021-03-29,ABR,5624,2524,3100,2985,2639,ITF,ITF1,13,Abruzzo
2021-02-07,VDA,292,120,172,190,102,ITC,ITC2,2,Valle d'Aosta / Vallée d'Aoste
2021-04-06,FVG,6278,2771,3507,5128,1150,ITH,ITH4,6,Friuli-Venezia Giulia
2021-05-01,VDA,940,563,377,456,484,ITC,ITC2,2,Valle d'Aosta / Vallée d'Aoste
2021-02-19,UMB,743,293,450,526,217,ITI,ITI2,10,Umbria
2021-01-08,TOS,5946,1642,4304,5946,0,ITI,ITI1,9,Toscana
2021-01-22,SAR,83,47,36,55,28,ITG,ITG2,20,Sardegna
2021-02-22,LIG,3334,1467,1867,3192,142,ITC,ITC3,7,Liguria
2021-03-01,PAT,1237,454,783,942,295,ITH,ITH2,4,Provincia Autonoma Trento
2021-03-24,CAL,7606,3463,4143,4368,3238,ITF,ITF6,18,Calabria
2021-03-14,BAS,1010,477,533,541,469,ITF,ITF5,17,Basilicata
2021-05-11,LAZ,47908,21959,25949,31515,16393,ITI,ITI4,12,Lazio
2021-01-02,VDA,6,5,1,6,0,ITC,ITC2,2,Valle d'Aosta / Vallée d'Aoste
2021-05-30,SIC,35483,16050,19433,17428,18055,ITG,ITG1,19,Sicilia
2021-03-26,VDA,498,204,294,491,7,ITC,ITC2,2,Valle d'Aosta / Vallée d'Aoste
2021-02-18,MOL,319,74,245,306,13,ITF,ITF2,14,Molise
2021-02-22,LOM,11897,4809,7088,11590,307,ITC,ITC4,3,Lombardia
2021-01-19,CAM,1095,474,621,1092,3,ITF,ITF3,15,Campania
2021-03-09,MOL,1329,579,750,1177,152,ITF,ITF2,14,Molise
2020-12-27,PAT,103,40,63,103,0,ITH,ITH2,4,Provincia Autonoma Trento
2021-05-25,FVG,12453,6071,6382,9276,3177,ITH,ITH4,6,Friuli-Venezia Giulia
2021-03-01,PIE,12041,4845,7196,11232,809,ITC,ITC1,1,Piemonte
2021-04-20,TOS,18157,8111,10046,12599,5558,ITI,ITI1,9,Toscana
2021-05-17,BAS,5539,2733,2806,3406,2133,ITF,ITF5,17,Basilicata
2021-03-11,PUG,14388,6198,8190,11279,3109,ITF,ITF4,16,Puglia
2021-01-21,VDA,33,12,21,33,0,ITC,ITC2,2,Valle d'Aosta / Vallée d'Aoste
2021-04-12,CAL,6899,3349,3550,5248,1651,ITF,ITF6,18,Calabria
2021-01-19,CAL,1111,490,621,1101,10,ITF,ITF6,18,Calabria
2021-02-14,EMR,1401,378,1023,1281,120,ITH,ITH5,8,Emilia-Romagna
2021-05-18,CAM,52047,23142,28905,32506,19541,ITF,ITF3,15,Campania
2021-05-18,LOM,88011,42052,45959,32582,55429,ITC,ITC4,3,Lombardia
2021-01-17,CAL,867,418,449,801,66,ITF,ITF6,18,Calabria
2021-02-19,SIC,5130,2732,2398,4564,566,ITG,ITG1,19,Sicilia
2021-02-24,LOM,14658,5923,8735,13731,927,ITC,ITC4,3,Lombardia
2021-01-31,LAZ,4459,1854,2605,476,3983,ITI,ITI4,12,Lazio
2021-04-17,SAR,10078,4500,5578,5481,4597,ITG,ITG2,20,Sardegna
2021-03-22,EMR,17464,7652,9812,10599,6865,ITH,ITH5,8,Emilia-Romagna
2021-04-29,CAM,41283,20006,21277,24817,16466,ITF,ITF3,15,Campania
2021-03-15,TOS,8356,3332,5024,3913,4443,ITI,ITI1,9,Toscana
2021-05-13,LAZ,49501,22178,27323,31860,17641,ITI,ITI4,12,Lazio
2021-05-14,MOL,2644,1215,1429,1926,718,ITF,ITF2,14,Molise
2021-04-24,SIC,31362,14805,16557,23622,7740,ITG,ITG1,19,Sicilia
2021-03-12,BAS,1902,978,924,803,1099,ITF,ITF5,17,Basilicata
2021-01-10,TOS,3001,1104,1897,3001,0,ITI,ITI1,9,Toscana
2021-04-27,LIG,14735,6675,8060,7156,7579,ITC,ITC3,7,Liguria
2021-04-03,TOS,15014,6646,8368,13888,1126,ITI,ITI1,9,Toscana
2021-04-29,CAL,11825,5744,6081,8309,3516,ITF,ITF6,18,Calabria
2021-02-23,ABR,2782,1275,1507,2771,11,ITF,ITF1,13,Abruzzo
2021-06-02,PUG,26114,12810,13304,21472,4642,ITF,ITF4,16,Puglia
2021-06-01,UMB,4364,2083,2281,4217,147,ITI,ITI2,10,Umbria
2021-05-25,PIE,31002,14365,16637,15962,15040,ITC,ITC1,1,Piemonte
2021-05-25,EMR,24799,11055,13744,11580,13219,ITH,ITH5,8,Emilia-Romagna
2021-03-28,VDA,522,212,310,521,1,ITC,ITC2,2,Valle d'Aosta / Vallée d'Aoste
2021-04-29,LIG,15548,6974,8574,6731,8817,ITC,ITC3,7,Liguria
2021-02-08,ABR,1197,396,801,487,710,ITF,ITF1,13,Abruzzo
2021-02-07,LOM,7307,2822,4485,338,6969,ITC,ITC4,3,Lombardia
2021-04-14,CAM,27639,13330,14309,19073,8566,ITF,ITF3,15,Campania
2021-02-26,TOS,10076,3833,6243,8870,1206,ITI,ITI1,9,Toscana
2021-01-19,LOM,8070,2335,5735,7602,468,ITC,ITC4,3,Lombardia
2021-04-07,LAZ,24958,11320,13638,17654,7304,ITI,ITI4,12,Lazio
2021-05-25,PAT,4747,2261,2486,1856,2891,ITH,ITH2,4,Provincia Autonoma Trento
2021-01-02,CAM,3673,1962,1711,3673,0,ITF,ITF3,15,Campania
2021-04-26,UMB,5375,2328,3047,3123,2252,ITI,ITI2,10,Umbria
2021-05-09,PAB,4234,2405,1829,3081,1153,ITH,ITH1,4,Provincia Autonoma Bolzano / Bozen
2021-02-14,PAT,246,186,60,11,235,ITH,ITH2,4,Provincia Autonoma Trento
2021-04-13,ABR,5879,2752,3127,4679,1200,ITF,ITF1,13,Abruzzo
2021-01-14,SIC,5263,2521,2742,5263,0,ITG,ITG1,19,Sicilia
2021-02-02,LAZ,5909,2213,3696,637,5272,ITI,ITI4,12,Lazio
2021-02-03,MOL,731,249,482,338,393,ITF,ITF2,14,Molise
2021-05-10,EMR,33586,15993,17593,26358,7228,ITH,ITH5,8,Emilia-Romagna
2021-03-06,PAB,3972,2081,1891,3761,211,ITH,ITH1,4,Provincia Autonoma Bolzano / Bozen
2021-01-17,LIG,862,300,562,862,0,ITC,ITC3,7,Liguria
2021-05-15,UMB,4984,1875,3109,1819,3165,ITI,ITI2,10,Umbria
2021-01-20,BAS,84,22,62,84,0,ITF,ITF5,17,Basilicata
2021-02-22,PUG,9630,4537,5093,9298,332,ITF,ITF4,16,Puglia
2021-05-20,LOM,94154,45500,48654,31789,62365,ITC,ITC4,3,Lombardia
2021-05-10,FVG,7911,3514,4397,6372,1539,ITH,ITH4,6,Friuli-Venezia Giulia
2021-03-01,MAR,3724,1487,2237,3476,248,ITI,ITI3,11,Marche
2021-03-10,VEN,18935,8637,10298,13254,5681,ITH,ITH3,5,Veneto
2021-02-14,PIE,1476,498,978,876,600,ITC,ITC1,1,Piemonte
2021-06-03,VEN,35858,18238,17620,28199,7659,ITH,ITH3,5,Veneto
2021-01-16,UMB,221,73,148,221,0,ITI,ITI2,10,Umbria
2021-05-06,MAR,12655,5820,6835,5582,7073,ITI,ITI3,11,Marche
2021-05-27,FVG,12216,5765,6451,7168,5048,ITH,ITH4,6,Friuli-Venezia Giulia
2021-04-12,LIG,12381,5475,6906,10362,2019,ITC,ITC3,7,Liguria
2021-02-24,PUG,10034,4703,5331,9445,589,ITF,ITF4,16,Puglia
2021-01-19,LIG,1371,438,933,1281,90,ITC,ITC3,7,Liguria
2021-05-19,ABR,10693,5109,5584,7654,3039,ITF,ITF1,13,Abruzzo
2021-05-11,PAB,2842,1334,1508,1320,1522,ITH,ITH1,4,Provincia Autonoma Bolzano / Bozen
2021-04-26,SIC,21918,10372,11546,13780,8138,ITG,ITG1,19,Sicilia
2021-04-12,CAM,23301,10916,12385,20265,3036,ITF,ITF3,15,Campania
2021-01-29,PAB,1497,510,987,24,1473,ITH,ITH1,4,Provincia Autonoma Bolzano / Bozen
2021-02-25,BAS,1787,736,1051,1741,46,ITF,ITF5,17,Basilicata
2021-02-20,VDA,251,210,41,241,10,ITC,ITC2,2,Valle d'Aosta / Vallée d'Aoste
2021-06-02,PAT,2533,1214,1319,769,1764,ITH,ITH2,4,Provincia Autonoma Trento
2021-01-11,PUG,3753,1588,2165,3753,0,ITF,ITF4,16,Puglia
2021-04-13,PIE,25929,11608,14321,22469,3460,ITC,ITC1,1,Piemonte
2021-02-15,CAM,5470,2516,2954,5297,173,ITF,ITF3,15,Campania
2021-02-15,LOM,8940,3129,5811,8522,418,ITC,ITC4,3,Lombardia
2021-04-20,CAL,7843,3954,3889,6117,1726,ITF,ITF6,18,Calabria
2021-03-09,MAR,5428,2290,3138,4548,880,ITI,ITI3,11,Marche
2021-01-01,TOS,2369,787,1582,2369,0,ITI,ITI1,9,Toscana
2021-06-02,FVG,9168,4836,4332,8897,271,ITH,ITH4,6,Friuli-Venezia Giulia
2021-03-13,SIC,12421,5480,6941,7838,4583,ITG,ITG1,19,Sicilia
2021-03-06,TOS,7094,2838,4256,2901,4193,ITI,ITI1,9,Toscana
2021-02-07,FVG,1561,483,1078,385,1176,ITH,ITH4,6,Friuli-Venezia Giulia
2021-01-03,PAT,492,160,332,492,0,ITH,ITH2,4,Provincia Autonoma Trento
2021-03-20,SAR,5193,2073,3120,2916,2277,ITG,ITG2,20,Sardegna
2021-02-06,PAB,2626,1171,1455,19,2607,ITH,ITH1,4,Provincia Autonoma Bolzano / Bozen
2021-05-18,FVG,10559,5269,5290,8542,2017,ITH,ITH4,6,Friuli-Venezia Giulia
2021-04-20,LIG,14207,6503,7704,9861,4346,ITC,ITC3,7,Liguria
2021-06-01,FVG,9380,4686,4694,7319,2061,ITH,ITH4,6,Friuli-Venezia Giulia
2020-12-27,LOM,717,413,304,717,0,ITC,ITC4,3,Lombardia
2021-02-07,EMR,4793,1537,3256,1732,3061,ITH,ITH5,8,Emilia-Romagna
2021-03-02,ABR,3963,1676,2287,3279,684,ITF,ITF1,13,Abruzzo
2021-06-02,MAR,11913,5943,5970,11236,677,ITI,ITI3,11,Marche
2021-01-15,TOS,3878,1347,2531,3878,0,ITI,ITI1,9,Toscana
2021-02-12,UMB,671,224,447,665,6,ITI,ITI2,10,Umbria
2021-02-22,PAT,745,259,486,661,84,ITH,ITH2,4,Provincia Autonoma Trento
2021-03-29,FVG,6874,3001,3873,5295,1579,ITH,ITH4,6,Friuli-Venezia Giulia
2021-01-29,SAR,2955,1069,1886,48,2907,ITG,ITG2,20,Sardegna
2021-03-28,PAB,569,212,357,11,558,ITH,ITH1,4,Provincia Autonoma Bolzano / Bozen
2021-01-03,PIE,3063,967,2096,3063,0,ITC,ITC1,1,Piemonte
2021-03-29,EMR,21201,9443,11758,16550,4651,ITH,ITH5,8,Emilia-Romagna
2021-01-11,ABR,1551,557,994,1551,0,ITF,ITF1,13,Abruzzo
2021-03-19,BAS,2290,992,1298,262,2028,ITF,ITF5,17,Basilicata
2021-05-24,VDA,1135,516,619,688,447,ITC,ITC2,2,Valle d'Aosta / Vallée d'Aoste
2021-05-20,LAZ,50670,24179,26491,37413,13257,ITI,ITI4,12,Lazio
2021-05-10,VDA,782,381,401,547,235,ITC,ITC2,2,Valle d'Aosta / Vallée d'Aoste
2021-04-13,MAR,9838,4259,5579,9605,233,ITI,ITI3,11,Marche
2021-01-10,CAM,8165,3736,4429,8165,0,ITF,ITF3,15,Campania
2021-04-17,SIC,26189,13226,12963,19037,7152,ITG,ITG1,19,Sicilia
2021-01-07,UMB,1300,387,913,1300,0,ITI,ITI2,10,Umbria
2021-05-07,MOL,2641,1226,1415,2044,597,ITF,ITF2,14,Molise
2021-01-10,LIG,648,262,386,648,0,ITC,ITC3,7,Liguria
2021-03-03,VEN,12044,4597,7447,8546,3498,ITH,ITH3,5,Veneto
2021-05-18,PIE,31768,14577,17191,19318,12450,ITC,ITC1,1,Piemonte
2021-05-18,EMR,28981,13208,15773,18522,10459,ITH,ITH5,8,Emilia-Romagna
2021-02-16,ABR,1918,842,1076,1906,12,ITF,ITF1,13,Abruzzo
2021-01-28,BAS,903,401,502,119,784,ITF,ITF5,17,Basilicata
2021-03-21,VDA,355,165,190,355,0,ITC,ITC2,2,Valle d'Aosta / Vallée d'Aoste
2021-02-22,MAR,3413,1499,1914,3338,75,ITI,ITI3,11,Marche
2021-02-26,UMB,660,253,407,652,8,ITI,ITI2,10,Umbria
2021-03-18,MOL,1156,476,680,692,464,ITF,ITF2,14,Molise
2021-02-26,SIC,12207,5966,6241,10523,1684,ITG,ITG1,19,Sicilia
2021-01-14,BAS,969,413,556,969,0,ITF,ITF5,17,Basilicata
2021-04-22,VEN,31927,13897,18030,16182,15745,ITH,ITH3,5,Veneto
2021-03-01,LIG,3506,1430,2076,3384,122,ITC,ITC3,7,Liguria
2021-05-18,PAT,4245,2008,2237,3403,842,ITH,ITH2,4,Provincia Autonoma Trento
2021-03-29,PIE,15161,6385,8776,8549,6612,ITC,ITC1,1,Piemonte
2021-04-21,ABR,6384,3100,3284,4710,1674,ITF,ITF1,13,Abruzzo
2021-04-25,BAS,2985,1458,1527,2932,53,ITF,ITF5,17,Basilicata
2021-04-12,PIE,22924,10353,12571,19934,2990,ITC,ITC1,1,Piemonte
2021-01-03,MAR,897,349,548,897,0,ITI,ITI3,11,Marche
2021-05-21,MOL,2018,1011,1007,1707,311,ITF,ITF2,14,Molise
2021-01-27,MOL,674,251,423,8,666,ITF,ITF2,14,Molise
2021-04-21,CAL,11564,5806,5758,8630,2934,ITF,ITF6,18,Calabria
2021-01-07,SIC,9190,4250,4940,9190,0,ITG,ITG1,19,Sicilia
2021-04-06,ABR,7681,3581,4100,5362,2319,ITF,ITF1,13,Abruzzo
2021-03-08,MAR,6264,2744,3520,5262,1002,ITI,ITI3,11,Marche
2021-01-24,LIG,756,237,519,113,643,ITC,ITC3,7,Liguria
2021-03-05,SAR,5036,2445,2591,2682,2354,ITG,ITG2,20,Sardegna
2021-03-29,PAT,2461,958,1503,1726,735,ITH,ITH2,4,Provincia Autonoma Trento
2021-02-09,LAZ,8797,3768,5029,4580,4217,ITI,ITI4,12,Lazio
2021-04-12,PAT,3087,1408,1679,2591,496,ITH,ITH2,4,Provincia Autonoma Trento
2021-03-13,PAB,2885,1459,1426,2784,101,ITH,ITH1,4,Provincia Autonoma Bolzano / Bozen
2021-06-01,PIE,28854,14441,14413,24691,4163,ITC,ITC1,1,Piemonte
2021-03-17,VEN,14643,5991,8652,7849,6794,ITH,ITH3,5,Veneto
2021-06-01,TOS,26649,13180,13469,22977,3672,ITI,ITI1,9,Toscana
2021-04-04,VDA,572,253,319,571,1,ITC,ITC2,2,Valle d'Aosta / Vallée d'Aoste
2021-04-01,MOL,1469,667,802,743,726,ITF,ITF2,14,Molise
2021-02-15,ABR,1794,831,963,1752,42,ITF,ITF1,13,Abruzzo
2021-04-21,CAM,30222,14723,15499,17995,12227,ITF,ITF3,15,Campania
2021-05-17,EMR,32300,15368,16932,22862,9438,ITH,ITH5,8,Emilia-Romagna
2021-01-02,FVG,1216,470,746,1216,0,ITH,ITH4,6,Friuli-Venezia Giulia
2021-01-12,VEN,5230,1516,3714,5230,0,ITH,ITH3,5,Veneto
2021-04-27,MAR,9400,4309,5091,5413,3987,ITI,ITI3,11,Marche
2021-04-24,SAR,10366,4851,5515,8028,2338,ITG,ITG2,20,Sardegna
2021-03-31,LAZ,26106,12046,14060,19013,7093,ITI,ITI4,12,Lazio
2021-03-15,LIG,7193,3056,4137,4492,2701,ITC,ITC3,7,Liguria
2021-06-01,PAT,3693,1740,1953,1076,2617,ITH,ITH2,4,Provincia Autonoma Trento
2021-05-02,PAB,2457,1288,1169,1536,921,ITH,ITH1,4,Provincia Autonoma Bolzano / Bozen
2021-02-13,VDA,216,196,20,215,1,ITC,ITC2,2,Valle d'Aosta / Vallée d'Aoste
2021-05-06,VEN,46674,21899,24775,38234,8440,ITH,ITH3,5,Veneto
2021-04-12,TOS,2612,1183,1429,1958,654,ITI,ITI1,9,Toscana
2021-01-28,SAR,2970,1045,1925,69,2901,ITG,ITG2,20,Sardegna
2021-02-21,EMR,4450,1708,2742,4010,440,ITH,ITH5,8,Emilia-Romagna
2021-01-02,PIE,3545,1134,2411,3545,0,ITC,ITC1,1,Piemonte
2021-02-10,MOL,150,78,72,130,20,ITF,ITF2,14,Molise
2021-04-22,PUG,22901,10465,12436,18033,4868,ITF,ITF4,16,Puglia
2021-01-02,PAT,502,143,359,502,0,ITH,ITH2,4,Provincia Autonoma Trento
2021-03-30,PUG,11872,5494,6378,5977,5895,ITF,ITF4,16,Puglia
2021-02-01,PUG,3965,1659,2306,375,3590,ITF,ITF4,16,Puglia
2021-04-02,BAS,2318,1046,1272,1714,604,ITF,ITF5,17,Basilicata
2021-02-07,CAM,2929,1382,1547,2158,771,ITF,ITF3,15,Campania
2021-02-04,BAS,1096,442,654,63,1033,ITF,ITF5,17,Basilicata
2021-04-22,LAZ,38528,18929,19599,23951,14577,ITI,ITI4,12,Lazio
2021-04-17,UMB,6665,3059,3606,5325,1340,ITI,ITI2,10,Umbria
2021-05-16,TOS,26660,12879,13781,24200,2460,ITI,ITI1,9,Toscana
2021-02-28,VDA,260,86,174,77,183,ITC,ITC2,2,Valle d'Aosta / Vallée d'Aoste
2021-04-16,MOL,2430,1033,1397,1198,1232,ITF,ITF2,14,Molise
2021-05-20,CAL,16893,8434,8459,11289,5604,ITF,ITF6,18,Calabria
2021-04-09,BAS,1152,350,802,1089,63,ITF,ITF5,17,Basilicata
2021-04-20,LOM,67626,30820,36806,57291,10335,ITC,ITC4,3,Lombardia
2021-01-10,LOM,10520,3957,6563,10520,0,ITC,ITC4,3,Lombardia
2021-02-07,CAL,859,427,432,147,712,ITF,ITF6,18,Calabria
2021-03-13,TOS,9275,3301,5974,5312,3963,ITI,ITI1,9,Toscana
2021-01-25,PUG,3824,1681,2143,423,3401,ITF,ITF4,16,Puglia
2021-05-03,VDA,839,400,439,488,351,ITC,ITC2,2,Valle d'Aosta / Vallée d'Aoste
2021-05-09,TOS,22515,9760,12755,9656,12859,ITI,ITI1,9,Toscana
2021-03-07,VDA,64,30,34,11,53,ITC,ITC2,2,Valle d'Aosta / Vallée d'Aoste
2021-04-23,MOL,2049,882,1167,1390,659,ITF,ITF2,14,Molise
2021-04-27,LOM,85918,39952,45966,69379,16539,ITC,ITC4,3,Lombardia
2021-05-15,BAS,6527,3341,3186,3955,2572,ITF,ITF5,17,Basilicata
2021-02-05,TOS,5749,2245,3504,1924,3825,ITI,ITI1,9,Toscana
2021-03-10,LAZ,22021,9489,12532,16375,5646,ITI,ITI4,12,Lazio
2021-03-11,MOL,1463,636,827,1457,6,ITF,ITF2,14,Molise
2021-03-15,CAL,3547,1682,1865,2112,1435,ITF,ITF6,18,Calabria
2021-01-12,LAZ,5413,1981,3432,5413,0,ITI,ITI4,12,Lazio
2021-05-14,PUG,44568,20326,24242,28510,16058,ITF,ITF4,16,Puglia
2021-04-29,LOM,115398,53551,61847,85588,29810,ITC,ITC4,3,Lombardia
2021-01-06,MOL,689,260,429,689,0,ITF,ITF2,14,Molise
2021-01-24,EMR,2443,885,1558,298,2145,ITH,ITH5,8,Emilia-Romagna
2021-05-11,TOS,27937,12980,14957,12480,15457,ITI,ITI1,9,Toscana
2021-03-17,LAZ,13786,5896,7890,7531,6255,ITI,ITI4,12,Lazio
2021-01-17,LOM,8337,3341,4996,8137,200,ITC,ITC4,3,Lombardia
2021-03-15,LOM,31556,11331,20225,23040,8516,ITC,ITC4,3,Lombardia
2021-05-18,CAL,15375,7679,7696,11914,3461,ITF,ITF6,18,Calabria
2021-01-17,CAM,1155,551,604,702,453,ITF,ITF3,15,Campania
2021-03-22,CAL,4883,2290,2593,3130,1753,ITF,ITF6,18,Calabria
2021-01-29,TOS,6144,1700,4444,304,5840,ITI,ITI1,9,Toscana
2021-03-15,CAM,12932,6088,6844,8187,4745,ITF,ITF3,15,Campania
2021-04-24,UMB,4562,1963,2599,3384,1178,ITI,ITI2,10,Umbria
2021-01-13,MOL,474,160,314,474,0,ITF,ITF2,14,Molise
2021-01-17,EMR,2890,887,2003,2644,246,ITH,ITH5,8,Emilia-Romagna
2021-02-27,BAS,1992,860,1132,1828,164,ITF,ITF5,17,Basilicata
2021-05-25,LIG,13718,6598,7120,10729,2989,ITC,ITC3,7,Liguria
2021-01-30,VDA,439,202,237,14,425,ITC,ITC2,2,Valle d'Aosta / Vallée d'Aoste
2021-02-16,CAM,5440,2411,3029,4669,771,ITF,ITF3,15,Campania
2021-04-08,PUG,17444,7570,9874,11271,6173,ITF,ITF4,16,Puglia
2021-01-09,FVG,2513,841,1672,2513,0,ITH,ITH4,6,Friuli-Venezia Giulia
2021-03-12,UMB,2653,1040,1613,2157,496,ITI,ITI2,10,Umbria
2021-03-17,LOM,26258,10489,15769,15254,11004,ITC,ITC4,3,Lombardia
2021-03-22,LIG,7663,3399,4264,4727,2936,ITC,ITC3,7,Liguria
2021-05-13,VEN,43953,21695,22258,34081,9872,ITH,ITH3,5,Veneto
2021-01-31,TOS,3050,1129,1921,106,2944,ITI,ITI1,9,Toscana
2021-03-07,FVG,2547,932,1615,2546,1,ITH,ITH4,6,Friuli-Venezia Giulia
2021-05-04,MAR,10845,4789,6056,4950,5895,ITI,ITI3,11,Marche
2021-05-18,LIG,13320,6010,7310,10035,3285,ITC,ITC3,7,Liguria
2021-03-12,SIC,13101,5604,7497,10884,2217,ITG,ITG1,19,Sicilia
2021-04-05,TOS,15279,6823,8456,14542,737,ITI,ITI1,9,Toscana
2021-04-14,CAL,8150,3922,4228,6703,1447,ITF,ITF6,18,Calabria
2021-02-16,CAL,1735,732,1003,1456,279,ITF,ITF6,18,Calabria
2021-04-01,PUG,13505,6158,7347,7162,6343,ITF,ITF4,16,Puglia
2021-01-14,UMB,752,201,551,752,0,ITI,ITI2,10,Umbria
2021-02-03,PUG,5036,2005,3031,730,4306,ITF,ITF4,16,Puglia
2021-03-19,UMB,1743,565,1178,1087,656,ITI,ITI2,10,Umbria
2021-02-09,CAM,4643,2202,2441,4391,252,ITF,ITF3,15,Campania
2021-05-18,TOS,28701,14144,14557,19987,8714,ITI,ITI1,9,Toscana
2021-05-08,SAR,13075,5960,7115,10788,2287,ITG,ITG2,20,Sardegna
2021-04-07,VEN,35894,16113,19781,28566,7328,ITH,ITH3,5,Veneto
2021-03-14,UMB,66,48,18,66,0,ITI,ITI2,10,Umbria
2021-02-14,LIG,233,122,111,233,0,ITC,ITC3,7,Liguria
2021-05-15,SIC,57074,26664,30410,41704,15370,ITG,ITG1,19,Sicilia
2021-03-19,SIC,16516,8113,8403,10785,5731,ITG,ITG1,19,Sicilia
2021-05-27,CAM,72297,34758,37539,26213,46084,ITF,ITF3,15,Campania
2021-04-11,BAS,848,330,518,786,62,ITF,ITF5,17,Basilicata
2021-04-19,FVG,6705,3131,3574,3293,3412,ITH,ITH4,6,Friuli-Venezia Giulia
2021-03-22,MAR,5655,2376,3279,2527,3128,ITI,ITI3,11,Marche
2021-02-09,CAL,2146,905,1241,947,1199,ITF,ITF6,18,Calabria
2021-02-02,VEN,6508,1878,4630,396,6112,ITH,ITH3,5,Veneto
2021-02-07,LIG,407,153,254,2,405,ITC,ITC3,7,Liguria
2021-01-24,MAR,881,339,542,5,876,ITI,ITI3,11,Marche
2021-05-30,PAB,4758,2514,2244,752,4006,ITH,ITH1,4,Provincia Autonoma Bolzano / Bozen
2021-05-15,SAR,13754,6416,7338,10325,3429,ITG,ITG2,20,Sardegna
2021-03-31,VEN,38659,16261,22398,31165,7494,ITH,ITH3,5,Veneto
2021-03-21,UMB,665,330,335,665,0,ITI,ITI2,10,Umbria
2021-03-07,PIE,11976,4658,7318,11099,877,ITC,ITC1,1,Piemonte
2021-02-07,TOS,2805,952,1853,885,1920,ITI,ITI1,9,Toscana
2021-04-03,PAB,831,364,467,22,809,ITH,ITH1,4,Provincia Autonoma Bolzano / Bozen
2021-04-04,BAS,610,225,385,197,413,ITF,ITF5,17,Basilicata
2021-05-17,UMB,6360,3058,3302,4187,2173,ITI,ITI2,10,Umbria
2021-04-19,PAT,2622,1235,1387,2600,22,ITH,ITH2,4,Provincia Autonoma Trento
2021-05-20,LIG,12814,5941,6873,8796,4018,ITC,ITC3,7,Liguria
2021-03-24,CAM,17621,8082,9539,14664,2957,ITF,ITF3,15,Campania
2021-05-27,CAL,17419,8572,8847,9731,7688,ITF,ITF6,18,Calabria
2021-05-20,CAM,60449,27825,32624,43070,17379,ITF,ITF3,15,Campania
2021-03-24,LOM,43232,15600,27632,31350,11882,ITC,ITC4,3,Lombardia
2021-02-17,PAB,156,51,105,139,17,ITH,ITH1,4,Provincia Autonoma Bolzano / Bozen
2021-06-03,SAR,9710,4555,5155,6245,3465,ITG,ITG2,20,Sardegna
2021-05-08,EMR,31664,14822,16842,20253,11411,ITH,ITH5,8,Emilia-Romagna
2021-01-28,PIE,5591,1809,3782,384,5207,ITC,ITC1,1,Piemonte
2021-02-05,PUG,5635,2273,3362,1333,4302,ITF,ITF4,16,Puglia
2021-01-21,EMR,2164,729,1435,819,1345,ITH,ITH5,8,Emilia-Romagna
2021-02-28,SIC,7165,3063,4102,6535,630,ITG,ITG1,19,Sicilia
2021-03-04,ABR,5935,2359,3576,5013,922,ITF,ITF1,13,Abruzzo
2021-03-14,LAZ,17103,6614,10489,11949,5154,ITI,ITI4,12,Lazio
2021-03-19,VEN,13790,5668,8122,7697,6093,ITH,ITH3,5,Veneto
2021-03-01,MOL,661,274,387,447,214,ITF,ITF2,14,Molise
2021-01-26,LIG,2484,803,1681,13,2471,ITC,ITC3,7,Liguria
2021-01-26,CAM,7340,3726,3614,351,6989,ITF,ITF3,15,Campania
2021-03-04,BAS,1879,892,987,1084,795,ITF,ITF5,17,Basilicata
2021-06-03,PIE,27439,14082,13357,23988,3451,ITC,ITC1,1,Piemonte
2021-01-09,SIC,7328,3425,3903,7328,0,ITG,ITG1,19,Sicilia
2021-05-03,SIC,23464,10822,12642,13580,9884,ITG,ITG1,19,Sicilia
2021-03-12,EMR,18116,7552,10564,11399,6717,ITH,ITH5,8,Emilia-Romagna
2021-04-02,UMB,4308,1746,2562,3551,757,ITI,ITI2,10,Umbria
2021-05-15,EMR,33148,14955,18193,22795,10353,ITH,ITH5,8,Emilia-Romagna
2021-03-31,LOM,41927,16966,24961,26720,15207,ITC,ITC4,3,Lombardia
2021-04-05,LIG,3976,1751,2225,2327,1649,ITC,ITC3,7,Liguria
2021-05-27,VEN,45509,22354,23155,22918,22591,ITH,ITH3,5,Veneto
2021-01-23,UMB,280,100,180,2,278,ITI,ITI2,10,Umbria
2021-03-26,LAZ,28226,12253,15973,21383,6843,ITI,ITI4,12,Lazio
2021-02-02,EMR,9484,3053,6431,527,8957,ITH,ITH5,8,Emilia-Romagna
2021-01-14,PIE,9766,3152,6614,9766,0,ITC,ITC1,1,Piemonte
2021-03-31,TOS,32575,13135,19440,20418,12157,ITI,ITI1,9,Toscana
2021-03-31,CAL,8812,4003,4809,4855,3957,ITF,ITF6,18,Calabria
2021-01-26,LOM,8341,2707,5634,350,7991,ITC,ITC4,3,Lombardia
2021-01-22,MOL,126,35,91,126,0,ITF,ITF2,14,Molise
2021-02-20,ABR,4777,1842,2935,4701,76,ITF,ITF1,13,Abruzzo
2021-03-15,MAR,4401,2026,2375,1311,3090,ITI,ITI3,11,Marche
2021-01-31,LIG,624,270,354,9,615,ITC,ITC3,7,Liguria
2021-01-09,UMB,1745,499,1246,1745,0,ITI,ITI2,10,Umbria
2021-02-28,CAL,2305,1045,1260,2153,152,ITF,ITF6,18,Calabria
2021-01-09,SAR,4026,1417,2609,4026,0,ITG,ITG2,20,Sardegna
2021-05-04,PAB,3447,1843,1604,2410,1037,ITH,ITH1,4,Provincia Autonoma Bolzano / Bozen
2021-04-07,PIE,23606,9995,13611,18143,5463,ITC,ITC1,1,Piemonte
2021-04-19,LOM,60090,27338,32752,50687,9403,ITC,ITC4,3,Lombardia
2021-03-31,FVG,8033,3503,4530,7187,846,ITH,ITH4,6,Friuli-Venezia Giulia
2021-05-01,TOS,23309,10061,13248,14135,9174,ITI,ITI1,9,Toscana
2021-06-03,LOM,49279,24917,24362,42865,6414,ITC,ITC4,3,Lombardia
2021-01-20,VDA,23,8,15,23,0,ITC,ITC2,2,Valle d'Aosta / Vallée d'Aoste
2021-03-30,ABR,5056,2197,2859,3232,1824,ITF,ITF1,13,Abruzzo
2021-01-26,TOS,5393,1792,3601,220,5173,ITI,ITI1,9,Toscana
2021-03-10,LIG,5877,2839,3038,3971,1906,ITC,ITC3,7,Liguria
2021-05-30,MOL,1822,903,919,1538,284,ITF,ITF2,14,Molise
2021-04-07,EMR,25804,11735,14069,19793,6011,ITH,ITH5,8,Emilia-Romagna
2021-02-09,SAR,2287,837,1450,1290,997,ITG,ITG2,20,Sardegna
2021-03-20,PAB,1757,848,909,1132,625,ITH,ITH1,4,Provincia Autonoma Bolzano / Bozen
2021-02-21,CAM,5834,2239,3595,5609,225,ITF,ITF3,15,Campania
2021-03-19,PAT,2423,915,1508,1571,852,ITH,ITH2,4,Provincia Autonoma Trento
2021-05-29,SIC,47142,21412,25730,23918,23224,ITG,ITG1,19,Sicilia
2021-02-16,LAZ,8354,4033,4321,7749,605,ITI,ITI4,12,Lazio
2021-04-16,BAS,3319,1632,1687,2421,898,ITF,ITF5,17,Basilicata
2021-03-02,UMB,3642,1346,2296,3638,4,ITI,ITI2,10,Umbria
2021-04-19,VEN,21527,8916,12611,5117,16410,ITH,ITH3,5,Veneto
2021-03-12,PIE,13949,5184,8765,11014,2935,ITC,ITC1,1,Piemonte
2021-04-07,SAR,13477,5985,7492,7829,5648,ITG,ITG2,20,Sardegna
2021-02-02,TOS,3742,1475,2267,195,3547,ITI,ITI1,9,Toscana
2021-05-15,PAT,1567,815,752,679,888,ITH,ITH2,4,Provincia Autonoma Trento
2021-04-03,PUG,10542,4634,5908,6988,3554,ITF,ITF4,16,Puglia
2021-03-26,PIE,17748,6982,10766,8840,8908,ITC,ITC1,1,Piemonte
2021-04-21,SIC,22684,10884,11800,16457,6227,ITG,ITG1,19,Sicilia
2021-03-09,BAS,1394,709,685,790,604,ITF,ITF5,17,Basilicata
2021-01-21,CAL,960,445,515,930,30,ITF,ITF6,18,Calabria
2021-04-07,SIC,15537,7637,7900,8373,7164,ITG,ITG1,19,Sicilia
2021-01-11,BAS,183,66,117,183,0,ITF,ITF5,17,Basilicata
2021-06-03,SIC,28549,12749,15800,20851,7698,ITG,ITG1,19,Sicilia
2021-01-14,CAM,7073,2977,4096,7073,0,ITF,ITF3,15,Campania
2021-02-23,UMB,1693,658,1035,1651,42,ITI,ITI2,10,Umbria
2021-04-24,LIG,8169,3785,4384,5018,3151,ITC,ITC3,7,Liguria
2021-02-26,LIG,3765,1523,2242,3437,328,ITC,ITC3,7,Liguria
2021-05-22,PIE,33304,15048,18256,17194,16110,ITC,ITC1,1,Piemonte
2021-04-09,UMB,6791,3162,3629,6572,219,ITI,ITI2,10,Umbria
2020-12-28,LAZ,959,412,547,959,0,ITI,ITI4,12,Lazio
2021-04-29,PUG,25936,12006,13930,19281,6655,ITF,ITF4,16,Puglia
2021-04-19,PIE,22532,10762,11770,18168,4364,ITC,ITC1,1,Piemonte
2021-01-09,PIE,6184,2185,3999,6184,0,ITC,ITC1,1,Piemonte
2021-02-06,BAS,902,367,535,146,756,ITF,ITF5,17,Basilicata
2021-05-27,PAT,4193,1968,2225,1232,2961,ITH,ITH2,4,Provincia Autonoma Trento
2021-03-24,LIG,8942,3833,5109,5656,3286,ITC,ITC3,7,Liguria
2021-04-30,BAS,5284,2373,2911,4121,1163,ITF,ITF5,17,Basilicata
2021-05-15,VEN,36070,17442,18628,26143,9927,ITH,ITH3,5,Veneto
2021-02-04,UMB,733,226,507,25,708,ITI,ITI2,10,Umbria
2021-05-25,MAR,11646,5744,5902,8717,2929,ITI,ITI3,11,Marche
2021-01-02,CAL,166,94,72,166,0,ITF,ITF6,18,Calabria
2021-03-12,SAR,6699,2796,3903,5342,1357,ITG,ITG2,20,Sardegna
2021-03-08,PAB,1200,526,674,1173,27,ITH,ITH1,4,Provincia Autonoma Bolzano / Bozen
2021-03-07,SAR,1657,750,907,1117,540,ITG,ITG2,20,Sardegna
2021-04-12,LOM,47222,20571,26651,32890,14332,ITC,ITC4,3,Lombardia
2021-03-31,PAT,2567,983,1584,1710,857,ITH,ITH2,4,Provincia Autonoma Trento
2021-05-11,PUG,32250,14189,18061,13915,18335,ITF,ITF4,16,Puglia
2021-02-09,PIE,7392,2316,5076,722,6670,ITC,ITC1,1,Piemonte
2021-02-21,LOM,5052,1862,3190,5034,18,ITC,ITC4,3,Lombardia
2021-02-02,FVG,2467,806,1661,217,2250,ITH,ITH4,6,Friuli-Venezia Giulia
2021-04-26,CAL,10198,5066,5132,7777,2421,ITF,ITF6,18,Calabria
2021-03-05,TOS,16494,6336,10158,11752,4742,ITI,ITI1,9,Toscana
2021-05-29,CAM,67566,32103,35463,43937,23629,ITF,ITF3,15,Campania
2021-03-26,EMR,23415,9899,13516,16981,6434,ITH,ITH5,8,Emilia-Romagna
2021-01-07,FVG,2091,717,1374,2091,0,ITH,ITH4,6,Friuli-Venezia Giulia
2021-03-05,FVG,3736,1478,2258,2663,1073,ITH,ITH4,6,Friuli-Venezia Giulia
2021-02-04,LAZ,6302,2481,3821,987,5315,ITI,ITI4,12,Lazio
2021-02-02,SAR,1482,655,827,241,1241,ITG,ITG2,20,Sardegna
2021-05-20,TOS,29452,13656,15796,18895,10557,ITI,ITI1,9,Toscana
2021-04-10,PUG,30724,13029,17695,26500,4224,ITF,ITF4,16,Puglia
2021-04-11,ABR,5331,2606,2725,4847,484,ITF,ITF1,13,Abruzzo
2021-05-14,VDA,960,442,518,291,669,ITC,ITC2,2,Valle d'Aosta / Vallée d'Aoste
2021-01-07,PAT,1270,310,960,1270,0,ITH,ITH2,4,Provincia Autonoma Trento
2020-12-31,FVG,1053,384,669,1053,0,ITH,ITH4,6,Friuli-Venezia Giulia
2021-05-22,LAZ,54669,26647,28022,44251,10418,ITI,ITI4,12,Lazio
2021-03-31,EMR,25131,10949,14182,19675,5456,ITH,ITH5,8,Emilia-Romagna
2021-02-01,VDA,404,127,277,87,317,ITC,ITC2,2,Valle d'Aosta / Vallée d'Aoste
2021-03-30,VDA,402,223,179,382,20,ITC,ITC2,2,Valle d'Aosta / Vallée d'Aoste
2021-03-20,MOL,2321,968,1353,1000,1321,ITF,ITF2,14,Molise
2021-01-05,PUG,5104,2249,2855,5104,0,ITF,ITF4,16,Puglia
2021-05-10,LAZ,44305,20224,24081,30933,13372,ITI,ITI4,12,Lazio
2021-03-12,LOM,35253,12953,22300,25051,10202,ITC,ITC4,3,Lombardia
2021-05-15,CAL,26834,12856,13978,20063,6771,ITF,ITF6,18,Calabria
2021-04-03,MAR,7573,3204,4369,6903,670,ITI,ITI3,11,Marche
2021-01-06,ABR,1830,664,1166,1830,0,ITF,ITF1,13,Abruzzo
2021-04-19,TOS,9091,4505,4586,8063,1028,ITI,ITI1,9,Toscana
2021-05-03,SAR,8180,3817,4363,6584,1596,ITG,ITG2,20,Sardegna
2021-02-02,CAL,2287,1114,1173,177,2110,ITF,ITF6,18,Calabria
2021-03-07,SIC,9263,3454,5809,8180,1083,ITG,ITG1,19,Sicilia
2021-01-14,EMR,8128,2593,5535,8128,0,ITH,ITH5,8,Emilia-Romagna
2021-05-29,UMB,7825,3594,4231,6270,1555,ITI,ITI2,10,Umbria
2021-01-07,TOS,6018,1751,4267,6018,0,ITI,ITI1,9,Toscana
2021-02-09,LOM,12205,3331,8874,4033,8172,ITC,ITC4,3,Lombardia
2021-02-17,MOL,72,32,40,57,15,ITF,ITF2,14,Molise
2021-02-28,EMR,6823,2527,4296,4977,1846,ITH,ITH5,8,Emilia-Romagna
2021-04-26,EMR,27856,12912,14944,18550,9306,ITH,ITH5,8,Emilia-Romagna
2021-02-01,ABR,1632,573,1059,271,1361,ITF,ITF1,13,Abruzzo
2021-03-23,ABR,4783,2144,2639,2217,2566,ITF,ITF1,13,Abruzzo
2021-04-25,VDA,849,408,441,710,139,ITC,ITC2,2,Valle d'Aosta / Vallée d'Aoste
2021-01-25,ABR,1603,632,971,19,1584,ITF,ITF1,13,Abruzzo
2021-02-27,VDA,231,85,146,124,107,ITC,ITC2,2,Valle d'Aosta / Vallée d'Aoste
2021-04-14,LAZ,29270,13261,16009,19149,10121,ITI,ITI4,12,Lazio
2021-04-15,MOL,1924,793,1131,1080,844,ITF,ITF2,14,Molise
2021-02-21,FVG,801,281,520,423,378,ITH,ITH4,6,Friuli-Venezia Giulia
2021-03-27,PAB,3049,1553,1496,1543,1506,ITH,ITH1,4,Provincia Autonoma Bolzano / Bozen
2021-02-23,LAZ,11087,4780,6307,10326,761,ITI,ITI4,12,Lazio
2021-05-27,LOM,94287,45205,49082,41219,53068,ITC,ITC4,3,Lombardia
2021-02-21,TOS,5105,2089,3016,4935,170,ITI,ITI1,9,Toscana
2021-03-19,SAR,7269,3049,4220,5054,2215,ITG,ITG2,20,Sardegna
2021-02-21,PIE,5090,2083,3007,4988,102,ITC,ITC1,1,Piemonte
2021-03-03,PUG,16669,6705,9964,14757,1912,ITF,ITF4,16,Puglia
2021-01-02,EMR,2372,913,1459,2372,0,ITH,ITH5,8,Emilia-Romagna
2021-02-05,PAB,3195,1181,2014,8,3187,ITH,ITH1,4,Provincia Autonoma Bolzano / Bozen
2021-05-26,ABR,13306,5904,7402,8380,4926,ITF,ITF1,13,Abruzzo
2021-02-21,PAT,155,92,63,43,112,ITH,ITH2,4,Provincia Autonoma Trento
2021-04-12,FVG,7253,3181,4072,6122,1131,ITH,ITH4,6,Friuli-Venezia Giulia
2021-01-26,VEN,6917,2091,4826,152,6765,ITH,ITH3,5,Veneto
2021-01-14,SAR,1105,426,679,1105,0,ITG,ITG2,20,Sardegna
2021-04-07,LOM,50518,20874,29644,34708,15810,ITC,ITC4,3,Lombardia
2021-01-22,PAB,248,143,105,124,124,ITH,ITH1,4,Provincia Autonoma Bolzano / Bozen
2021-01-17,MAR,1607,687,920,1550,57,ITI,ITI3,11,Marche
